Key,GetIt citation,# links: common,# links: Ariadne only,# links: GetIt only,# links: Ariadne total,# links: GetIt total,# links: All Total,% total: Ariadne,% total: GetIt,ARIADNE: BACKEND_API_FETCH_ERROR_FAILED_TO_FETCH,ARIADNE: HTTP_400_BAD_REQUEST,GETIT: PAGE_NOT_FOUND,GETIT: PROBABLE_HTTP_400_BAD_REQUEST,GETIT: SORRY_SOMETHING_HAS_GONE_WRONG
"getit.library.nyu.edu/resolve??charset=utf-8&atitle=The impact of advertising on social processes&jtitle=Mind & Society=&title=Mind & Society=&issn=1860-1839(ELECTRONIC),15937879(PRINT)&date=2021&aulast=Pavlovskaya&aufirst=Olga&au=Pavlovskaya,Olga&genre=article","Article | The impact of advertising on social processes | Pavlovskaya,Olga 2021 | Published in Journal Mind  | ISSN:0026-4423",2,1,3,3,5,8,38,63,0,0,0,0,0
"getit.library.nyu.edu/resolve??charset=utf-8&pages=213-231&atitle=Between horror and boredom: Fairy tales and moral education&jtitle=Ethics and Education&title=Ethics and Education&issn=1744-9650(ELECTRONIC),17449642(PRINT)&volume=15&issue=2&date=2020&aulast=Lewin&aufirst=David&au=Lewin,David&genre=article","Article | Between horror and boredom Fairy tales and moral education | Lewin,David 2020 | Published in Journal Ethics and Education Volume 15 Issue 2 Page 213 231. | ISSN:1744-9642",2,0,0,2,2,4,50,50,0,0,0,0,0
"getit.library.nyu.edu/resolve??charset=utf-8&pages=28-34&atitle=EMDR Group Therapy With Women Who Were Sexually Assaulted in the Congo&jtitle=Journal of EMDR Practice & Research=&title=Journal of EMDR Practice & Research=&issn=1933-3196&volume=9&issue=1&date=2015&aulast=Alton&aufirst=Michel&au=Alton,Michel&genre=article","Article | EMDR Group Therapy With Women Who Were Sexually Assaulted in the Congo | Alton,Michel 2015 | Published in Journal Journal of EMDR Practice Volume 9 Issue 1 Page 28 34. | ISSN:1933-3196",1,0,0,1,1,2,50,50,0,0,0,0,0
"getit.library.nyu.edu/resolve??charset=utf-8&pages=49-53&atitle=Distinctly regulated functions and mobilization of CD11c-positive cells elicited by TLR3- and IPS-1 signaling in the cornea&jtitle=Immunology letters&title=Immunology letters&issn=0165-2478&volume=206&date=2019&aulast=Ueta&aufirst=Mayumi&au=Ueta,Mayumi&genre=article","Article | Distinctly regulated functions and mobilization of CD11c-positive cells elicited by TLR3 and IPS-1 signaling in the cornea | Ueta,Mayumi 2019 | Published in Journal Immunology letters Volume 206 Page 49 53. | ISSN:0165-2478",1,0,0,1,1,2,50,50,0,0,0,0,0
"getit.library.nyu.edu/resolve??charset=utf-8&pages=635-640&atitle=Mediterranean Way of Drinking and Longevity&jtitle=Critical reviews in food science and nutrition&title=Critical reviews in food science and nutrition&volume=56&issue=4&date=2016&aulast=Giacosa&aufirst=Attilio&au=Giacosa,Attilio&genre=article","Article | Mediterranean Way of Drinking and Longevity | Giacosa,Attilio 2016 | Published in Journal Critical reviews in food science and nutrition Volume 56 Issue 4 Page 635 640. | ISSN:1040-8398",1,0,0,1,1,2,50,50,0,0,0,0,0
"getit.library.nyu.edu/resolve??charset=utf-8&title=Addressing Racial Disproportionality and Disparities in Human Services : Multisystemic Approaches&isbn=9780231537070&date=2014&aulast=Dettlaff&aufirst=Alan&au=Dettlaff,Alan","Book | Addressing racial disproportionality and disparities in human services multisystemic approaches | Dettlaff,Alan 2014 |  | Publisher:Columbia University Press ISBN:9780231537070",0,0,3,0,3,3,0,100,0,0,0,0,0
"getit.library.nyu.edu/resolve??charset=utf-8&title=Attachment across the life cycle&isbn=0203132475&date=1993&aulast=Marris&aufirst=Peter&au=Marris,Peter","Book | Attachment across the life cycle | Marris,Peter 1993 |  | Publisher:Routledge ISBN:0203132475",0,0,3,0,3,3,0,100,0,0,0,0,0
"getit.library.nyu.edu/resolve??charset=utf-8&title=Slavery, Childhood, and Abolition in Jamaica, 1788-1838&isbn=9780820348032&date=2015&aulast=Vasconcellos&aufirst=Colleen&au=Vasconcellos,Colleen A.",Book | Slavery childhood and abolition in Jamaica 1788-1838 | Vasconcellos Colleen A 2015 |  | Publisher:The University of Georgia Press ISBN:9780820348032,0,0,5,0,5,5,0,100,0,0,0,0,0
"getit.library.nyu.edu/resolve??charset=utf-8&title=What Do Dreams Do?&isbn=9780192550897&date=2020&aulast=Llewellyn&aufirst=Sue&au=Llewellyn,Sue",Book | What do dreams do? | Llewellyn Sue 2020 |  | Publisher:Oxford University Press Incorporated ISBN:9780192550897,0,0,1,0,1,1,0,100,0,0,0,0,0
getit.library.nyu.edu/resolve??ctx_ver=Z39.88-2004&ctx_enc=info:ofi/enc:UTF-8&url_ver=Z39.88-2004&rfr_id=info:sid/Elsevier:SD&svc_val_fmt=info:ofi/fmt:kev:mtx:sch_svc&rft_val_fmt=info:ofi/fmt:kev:mtx:journal&rft.aulast=BARANIUK&rft.auinit=C&rft.date=2020&rft.issn=02624079&rft.volume=248&rft.issue=3309&rft.spage=46&rft.epage=50&rft.title=New Scientist&rft.atitle=AI gets emotional&rft_id=info:doi/10.1016/S0262-4079(20)32050-9,Article | AI gets emotional | BARANIUK 2020 | Published in Journal New Scientist Volume 248 Issue 3309 Page 46 50. | ISSN:0262-4079,3,1,0,4,3,7,57,43,0,0,0,0,0
getit.library.nyu.edu/resolve??ctx_ver=Z39.88-2004&ctx_enc=info:ofi/enc:UTF-8&url_ver=Z39.88-2004&rfr_id=info:sid/Elsevier:SD&svc_val_fmt=info:ofi/fmt:kev:mtx:sch_svc&rft_val_fmt=info:ofi/fmt:kev:mtx:journal&rft.aulast=IYER&rft.auinit=A&rft.date=2021&rft.issn=10983600&rft.volume=23&rft.issue=11&rft.spage=2057&rft.epage=2066&rft.title=Genetics in Medicine&rft.atitle=Ethical challenges for a new generation of early-phase pediatric gene therapy trials&rft_id=info:doi/10.1038/s41436-021-01245-3,Article | Ethical challenges for a new generation of early-phase pediatric gene therapy trials | IYER 2021 | Published in Journal Genetics in Medicine Volume 23 Issue 11 Page 2057 2066. | ISSN:1098-3600,3,0,0,3,3,6,50,50,0,0,0,0,0
getit.library.nyu.edu/resolve??ctx_ver=Z39.88-2004&ctx_enc=info:ofi/enc:UTF-8&url_ver=Z39.88-2004&rfr_id=info:sid/Elsevier:SD&svc_val_fmt=info:ofi/fmt:kev:mtx:sch_svc&rft_val_fmt=info:ofi/fmt:kev:mtx:journal&rft.aulast=JANCZAK&rft.auinit=D&rft.date=2018&rft.issn=00256196&rft.volume=93&rft.issue=1&rft.spage=40&rft.epage=47&rft.title=Mayo Clinic Proceedings&rft.atitle=Rivaroxaban and Apixaban for Initial Treatment of Acute Venous Thromboembolism of Atypical Location&rft_id=info:doi/10.1016/j.mayocp.2017.10.007,Article | Rivaroxaban and Apixaban for Initial Treatment of Acute Venous Thromboembolism of Atypical Location | JANCZAK 2018 | Published in Journal Mayo Clinic Proceedings Volume 93 Issue 1 Page 40 47. | ISSN:0025-6196,5,0,0,5,5,10,50,50,0,0,0,0,0
getit.library.nyu.edu/resolve??ctx_ver=Z39.88-2004&rft_val_fmt=info:ofi/fmt:kev:mtx:book&rfr_id=info:sid/credoreference:credoreference&rft.genre=book&rft.btitle=Is This the Real Life?&rft.aulast=Blake&rft.aufirst=&rft.spage=167,"Book | Is This the Real Life? | Blake | Published in Book Page 167. | ",0,0,2,0,2,2,0,100,0,0,0,0,0
getit.library.nyu.edu/resolve??ctx_ver=Z39.88-2004&rft_val_fmt=info:ofi/fmt:kev:mtx:book&rfr_id=info:sid/credoreference:credoreference&rft.genre=book&rft.btitle=Remaking the American Mainstream: Assimilation and Contemporary Immigration&rft.date=2003&rft.aulast=Alba&rft.aufirst=Richard D.,"Book | Remaking the American Mainstream Assimilation and Contemporary Immigration | Alba Richard D 2003 |  | ",0,0,4,0,4,4,0,100,0,0,0,0,0
getit.library.nyu.edu/resolve??ctx_ver=Z39.88-2004&rft_val_fmt=info:ofi/fmt:kev:mtx:book&rfr_id=info:sid/credoreference:credoreference&rft.genre=book&rft.btitle=The Ojibwa Dance Drum: Its History and Construction&rft.date=1982.&rft.aulast=Vennum&rft.aufirst=Thomas Jr.,"Book | The Ojibwa Dance Drum Its History and Construction | Vennum Thomas Jr 1982 |  | ",0,0,1,0,1,1,0,100,0,0,0,0,0
getit.library.nyu.edu/resolve??ctx_ver=Z39.88-2004&rft_val_fmt=info:ofi/fmt:kev:mtx:book&rfr_id=info:sid/credoreference:credoreference&rft.genre=book&rft.btitle=The creation of feminist consciousness: From the middle ages to eighteen-seventy&rft.date=1993&rft.aulast=Lerner&rft.aufirst=G.,"Book | The creation of feminist consciousness From the middle ages to eighteen-seventy | Lerner G 1993 |  | ",1,0,3,1,4,5,20,80,0,0,0,0,0
getit.library.nyu.edu/resolve??sid=&aulast=Aristotle&aufirst=&genre=book&title=Oxford World's Classics: Aristotle: Poetics&date=2013&isbn=9780199608362,Book | Poetics | Aristotle 2013 |  | Publisher:Oxford University Press ISBN:9780199608362,0,0,1,0,1,1,0,100,0,0,0,0,0
getit.library.nyu.edu/resolve??sid=&aulast=Shakespeare&aufirst=William&genre=book&title=The Oxford Shakespeare: Hamlet&date=1987&isbn=9780198129103,Book | Hamlet | Shakespeare William 1987 |  | Publisher:Clarendon Press Oxford University Press ISBN:9780198129103,0,0,1,0,1,1,0,100,0,0,0,0,0
"getit.library.nyu.edu/resolve??sid=muse&pid=MUSE&genre=book&isbn=9780253018960&title=If\u00e1 Divination, Knowledge, Power, and Performance&date=2016",Book | Ifa divination knowledge power and performance | Olupona 2016 |  | Publisher:Indiana University Press ISBN:9780253018960,0,0,7,0,7,7,0,100,0,0,0,0,0
"getit.library.nyu.edu/resolve??sid=muse&pid=MUSE&genre=book&isbn=9780520958500&title=Love, Money, and HIV&date=2014&aulast=Sanyu A. Mojola&aufirst=",Book | Love money and HIV becoming a modern African woman in the age of AIDS | Mojola Sanyu A 2014 |  | Publisher:University of California Press ISBN:9780520958500,0,0,8,0,8,8,0,100,0,0,0,0,0
getit.library.nyu.edu/resolve??sid=oup:obo&genre=book&aulast=Larmour&title=Rethinking sexuality: Foucault and classical antiquity&date=1998,"Book | Rethinking sexuality Foucault and classical antiquity | Larmour 1998 |  | ",0,0,4,0,4,4,0,100,0,0,0,0,0
getit.library.nyu.edu/resolve??sid=oup:obo&genre=book&aulast=Rivera&title=Reggaeton&date=2009,"Book | Reggaeton | Rivera 2009 |  | ",0,0,8,0,8,8,0,100,0,0,0,0,0
getit.library.nyu.edu/resolve??sid=oup:obo&genre=book&aulast=Struck&title=Birth of the symbol: Ancient readers at the limits of their texts&date=2004,"Book | Birth of the symbol Ancient readers at the limits of their texts | Struck 2004 |  | ",1,0,8,1,9,10,10,90,0,0,0,0,0
getit.library.nyu.edu/resolve??sid=oup:obo&genre=book&aulast=Taylor&title=Propaganda&date=2007,"Book | Propaganda | Taylor 2007 |  | ",0,0,5,0,5,5,0,100,0,0,0,0,0
getit.library.nyu.edu/resolve??sid=oup:orr&genre=article&atitle=The effectiveness of the direct supervision system of correctional design and management: A review of the literature&aulast=Wener&aufirst=R. E&title=Criminal Justice & Behavior=&date=2006&spage=367&volume=33,Article | The effectiveness of the direct supervision system of correctional design and management A review of the literature | Wener R E 2006 | Published in Journal Criminal Justice Volume 33 Page 367. | ISSN:1075-2080,3,0,1,3,4,7,43,57,0,0,0,0,0
getit.library.nyu.edu/resolve??sid=oup:orr&genre=book&aulast=Pennycook&aufirst=A.&title=Language and Mobility: Unexpected Places&date=2012,"Book | Language and Mobility Unexpected Places | Pennycook A 2012 |  | ",0,0,4,0,4,4,0,100,0,0,0,0,0
getit.library.nyu.edu/resolve??sid=oup:oxmed&genre=book&aulast=Shaw&aufirst=Ian&isbn=9780198845461&title=Ancient Egypt: A Very Short Introduction&date=2021-01-28,Book | Ancient Egypt a very short introduction | Shaw Ian 2021 Jan 28 |  | Publisher:Oxford University Press USA ISBN:9780198845461,0,0,1,0,1,1,0,100,0,0,0,0,0
"getit.library.nyu.edu/resolve?ID=doi:10.1016/j.jadohealth.2014.07.023&genre=article&atitle=Original article: Prevalence and Determinants of Adolescent Pregnancy in Urban Disadvantaged Settings Across Five Cities&title=Journal of Adolescent Health&issn=1054139X&isbn=&volume=55&issue=6&date=20141201&aulast=Brahmbhatt, Heena&spage=S48&pages=&sid=EBSCO:ScienceDirect:S1054139X14003322",Article | Original article Prevalence and Determinants of Adolescent Pregnancy in Urban Disadvantaged Settings Across Five Cities | Brahmbhatt Heena 2014 Dec 01 | Published in Journal Journal of Adolescent Health Volume 55 Issue 6 Page S48. | ISSN:1054-139X,0,1,1,1,1,2,50,50,0,0,0,0,0
getit.library.nyu.edu/resolve?atitle=Evaluation+of+baking+conditions+for+frozen+doughs.&sid=cabi:cabdirect&title=Journal+of+Food+Measurement+and+Characterization&issn=2193-4126&spage=3307&epage=3317&aulast=Varmola&auinit=E.&date=2019&volume=13&issue=4&id=doi:10.1007/s11694-019-00253-x,Article | Evaluation of baking conditions for frozen doughs. | Varmola 2019 | Published in Journal Journal of Food Measurement and Characterization Volume 13 Issue 4 Page 3307 3317. | ISSN:2193-4126,3,0,0,3,3,6,50,50,0,0,0,0,0
"getit.library.nyu.edu/resolve?ctx_ver=Z39.88-2004&ctx_enc=info:ofi/enc:UTF-8&ctx_tim=2016-07-19T23:55:24IST&url_ver=Z39.88-2004&url_ctx_fmt=infofi/fmt:kev:mtx:ctx&rfr_id=info:sid/primo.exlibrisgroup.com:primo-dedupmrg27230747&rft_val_fmt=info:ofi/fmt:kev:mtx:book&rft.genre=book&rft.jtitle=&rft.btitle=Learning+Processing+a+beginner's+guide+to+programming+images,+animation,+and+interaction&rft.aulast=Shiffman&rft.aufirst=Daniel.&rft.auinit=&rft.auinit1=&rft.auinitm=&rft.ausuffix=&rft.au=Shiffman,+Daniel&rft.aucorp=&rft.volume=&rft.issue=&rft.part=&rft.quarter=&rft.ssn=&rft.spage=&rft.epage=&rft.pages=&rft.artnum=&rft.pub=Morgan+Kaufmann/Elsevier&rft.place=Amsterdam+;+Boston&rft.issn=&rft.eissn=&rft.isbn=9780123736024&rft.sici=&rft.coden=&rft_id=info:doi/&rft.object_id=&rft.primo=dedupmrg27230747&rft.eisbn=&rft_dat=<nyu_aleph>003290457</nyu_aleph><grp_id>22312689</grp_id><oa></oa>&rft_id=info:oai/&req.language=eng",Book | Learning Processing a beginner's guide to programming images animation and interaction | Shiffman Daniel 2009 |  | Publisher:Morgan Kaufmann/Elsevier ISBN:9780123736024,0,0,2,0,2,2,0,100,0,0,0,0,0
"getit.library.nyu.edu/resolve?ctx_ver=Z39.88-2004&ctx_enc=info:ofi/enc:UTF-8&ctx_tim=2018-01-19T14:15:24IST&url_ver=Z39.88-2004&url_ctx_fmt=infofi/fmt:kev:mtx:ctx&rfr_id=info:sid/primo.exlibrisgroup.com:primo-dedupmrg374692616&rft_val_fmt=info:ofi/fmt:kev:mtx:book&rft.genre=book&rft.jtitle=&rft.btitle=Interpretive research design : concepts and processes&rft.aulast=Schwartz-Shea&rft.aufirst=Peregrine,&rft.auinit=&rft.auinit1=&rft.auinitm=&rft.ausuffix=&rft.au=Schwartz-Shea, Peregrine, 1955-&rft.aucorp=&rft.volume=&rft.issue=&rft.part=&rft.quarter=&rft.ssn=&rft.spage=&rft.epage=&rft.pages=&rft.artnum=&rft.pub=Routledge&rft.place=New York&rft.issn=&rft.eissn=&rft.isbn=9781136993831&rft.sici=&rft.coden=&rft_id=info:doi/&rft.object_id=&rft.primo=dedupmrg374692616&rft.eisbn=&rft_dat=<nyu_aleph>004586164</nyu_aleph><grp_id>433395271</grp_id><oa></oa><url></url>&rft_id=info:oai/&req.language=eng",Book | Interpretive research design concepts and processes | Schwartz-Shea Peregrine 2013 |  | Publisher:Routledge ISBN:9781136993831,0,0,2,0,2,2,0,100,0,0,0,0,0
"getit.library.nyu.edu/resolve?ctx_ver=Z39.88-2004&ctx_enc=info:ofi/enc:UTF-8&ctx_tim=2018-01-19T15:28:53IST&url_ver=Z39.88-2004&url_ctx_fmt=infofi/fmt:kev:mtx:ctx&rfr_id=info:sid/primo.exlibrisgroup.com:primo-dedupmrg415011426&rft_val_fmt=info:ofi/fmt:kev:mtx:book&rft.genre=book&rft.jtitle=&rft.btitle=Racism in the United States : implications for the helping professions&rft.aulast=Miller&rft.aufirst=Joshua&rft.auinit=&rft.auinit1=&rft.auinitm=&rft.ausuffix=&rft.au=Miller, Joshua (Joshua L.), author&rft.aucorp=&rft.volume=&rft.issue=&rft.part=&rft.quarter=&rft.ssn=&rft.spage=&rft.epage=&rft.pages=&rft.artnum=&rft.pub=&rft.place=&rft.issn=&rft.eissn=9780826148841&rft.isbn=9780826148841&rft.sici=&rft.coden=&rft_id=info:doi/&rft.object_id=&rft.primo=dedupmrg415011426&rft.eisbn=&rft_dat=<nyu_aleph>005343580</nyu_aleph><grp_id>470076616</grp_id><oa></oa><url></url>&rft_id=info:oai/&req.language=eng",Book | Racism in the United States implications for the helping professions | Miller Joshua Joshua L author 2017 |  | Publisher:Springer Publishing Company ISBN:9780826148841,0,0,2,0,2,2,0,100,0,0,0,0,0
getit.library.nyu.edu/resolve?ctx_ver=Z39.88-2004&ctx_enc=info:ofi/enc:UTF-8&rfr_id=info:sid/ams.org:MathSciNet&rft_val_fmt=info:ofi/fmt:kev:mtx:book&rft_id=urn:ISBN:978-0-387-84898-3&rft.aufirst=Felipe&rft.auinit1=F&rft.aulast=Linares&rft.date=2009&rft.genre=book&rft.isbn=9780387848983&rft.stitle=Universitext.&rft.title=Introduction to nonlinear dispersive equations,Book | Introduction to nonlinear dispersive equations | Linares Felipe 2009 |  | Publisher:Springer ISBN:9780387848983,0,0,6,0,6,6,0,100,0,0,0,0,0
getit.library.nyu.edu/resolve?ctx_ver=Z39.88-2004&rft.genre=article&ctx_enc=info:ofi/enc:UTF-8&url_ver=Z39.88-2004&url_ctx_fmt=infofi/fmt:kev:mtx:ctx&rfr_id=info:sid/primo.exlibrisgroup.com:primo4-article-cLinker&rft_val_fmt=info:ofi/fmt:kev:mtx:article&isCitationLinker=Y&sfx.title_search=contains&rft.date=&rft_id=info:doi/10.1016/0006-291x(68)90706-7&rft.atitle=&rft.jtitle=&rft.volume=&rft.issue=&rft.spage=&rft.epage=&rft.issn=&rft.doi=10.1016/0006-291x(68)90706-7&rft.pmid=&rft.aulast=&rft.aufirst=&rft.auinit=&rft.publisher=&rft.pubdate=,Article | Photosensitized dimerization of pyrimidines | Greenstock C L 1968 | Published in Journal BIOCHEMICAL AND BIOPHYSICAL RESEARCH COMMUNICATIONS Volume 30 Issue 1 Page 21 27. | ISSN:0006-291X,1,0,0,1,1,2,50,50,0,0,0,0,0
"getit.library.nyu.edu/resolve?forcedownload=1&umlaut.referent_id=18782085&url_ver=Z39.88-2004&url_ctx_fmt=info:ofi/fmt:kev:mtx:ctx&ctx_ver=Z39.88-2004&ctx_tim=2022-01-09T13:40:59-05:00&ctx_id=&ctx_enc=info:ofi/enc:UTF-8&rft.atitle=The+From+Survivor+to+Thriver+program:+RCT+of+an+online+therapist-facilitated+program+for+rape-related+PTSD&rft.coden=JADIE8&rft.date=2016&rft.doi=10.1016/j.janxdis.2016.07.010&rft.eissn=1873-7897&rft.epage=51&rft.genre=article&rft.issn=08876185&rft.jtitle=Journal+of+anxiety+disorders&rft.language=fre&rft.lccn=++2004233010&rft.month=10&rft.object_id=954925553398&rft.place=UNITED+STATES&rft.pub=Pergamon&rft.spage=41&rft.stitle=J+ANXIETY+DISORDERS&rft.title=Journal+of+anxiety+disorders&rft.volume=43&rft.volume_start=43&rft.au=Littleton,+Heather&rft.aulast=Littleton&rft.aufirst=Heather&rft.auinit=H&rft_val_fmt=info:ofi/fmt:kev:mtx:journal&rft_id=info:doi/10.1016/j.janxdis.2016.07.010&rfr_id=info:sid/google",Article | The From Survivor to Thriver program RCT of an online therapist-facilitated program for rape-related PTSD | Littleton Heather 2016 | Published in Journal Journal of anxiety disorders Volume 43 Page 41 51. | ISSN:0887-6185,1,0,0,1,1,2,50,50,0,0,0,0,0
"getit.library.nyu.edu/resolve?forcedownload=1&umlaut.referent_id=18798757&url_ver=Z39.88-2004&url_ctx_fmt=info:ofi/fmt:kev:mtx:ctx&ctx_ver=Z39.88-2004&ctx_tim=2022-01-25T18:57:14-05:00&ctx_id=&ctx_enc=info:ofi/enc:UTF-8&rft.atitle=Standards+of+care+for+the+health+of+transsexual,+transgender,+and+gender-nonconforming+people,+version+7&rft.au=Coleman,+E&rft.auinit=E&rft.aulast=Coleman&rft.date=2012&rft.doi=10.1080/15532739.2011.700873&rft.eissn=1434-4599&rft.epage=232&rft.genre=article&rft.issn=1553-2739&rft.issue=4&rft.issue_start=4&rft.jtitle=International+journal+of+transgenderism&rft.language=fre&rft.lccn=+++00253291+&rft.month=08&rft.object_id=991042723500904&rft.place=Du\u0308sseldorf,+Germany&rft.pub=Symposion+Pub.&rft.spage=165&rft.stitle=INTERNATIONAL+JOURNAL+OF+TRANSGENDERISM&rft.title=International+journal+of+transgenderism&rft.volume=13&rft.volume_start=13&rft_val_fmt=info:ofi/fmt:kev:mtx:journal&rft_id=info:doi/10.1080/15532739.2011.700873&rfr_id=info:sid/google",Article | Standards of care for the health of transsexual transgender and gender-nonconforming people version 7 | Coleman E 2012 | Published in Journal International journal of transgenderism Volume 13 Issue 4 Page 165 232. | ISSN:1553-2739,2,0,0,2,2,4,50,50,0,0,0,0,0
"getit.library.nyu.edu/resolve?forcedownload=1&umlaut.referent_id=18814426&url_ver=Z39.88-2004&url_ctx_fmt=info:ofi/fmt:kev:mtx:ctx&ctx_ver=Z39.88-2004&ctx_tim=2022-02-06T15:59:19-05:00&ctx_id=&ctx_enc=info:ofi/enc:UTF-8&rft.atitle=From+gender+identity+disorder+to+gender+identity+creativity:+True+gender+self+child+therapy&rft.au=Ehrensaft,+Diane&rft.aufirst=Diane&rft.auinit=D&rft.aulast=Ehrensaft&rft.coden=JOHOD7&rft.date=2012&rft.doi=10.1080/00918369.2012.653303&rft.eissn=1540-3602&rft.epage=356&rft.genre=article&rft.issn=0091-8369&rft.issue=3&rft.issue_start=3&rft.jtitle=Journal+of+Homosexuality&rft.language=fre&rft.lccn=+++74078295+&rft.month=03&rft.object_id=954925463175&rft.oclcnum=1790856&rft.place=UNITED+STATES&rft.pub=Haworth+Press]&rft.spage=337&rft.stitle=J+HOMOSEX&rft.title=Journal+of+homosexuality&rft.volume=59&rft.volume_start=59&rft_val_fmt=info:ofi/fmt:kev:mtx:journal&rft_id=info:doi/10.1080/00918369.2012.653303&rfr_id=info:sid/google",Article | From gender identity disorder to gender identity creativity True gender self child therapy | Ehrensaft Diane 2012 | Published in Journal Journal of homosexuality Volume 59 Issue 3 Page 337 356. | ISSN:0091-8369,2,1,0,3,2,5,60,40,0,0,0,0,0
"getit.library.nyu.edu/resolve?forcedownload=1&umlaut.referent_id=18887651&url_ver=Z39.88-2004&url_ctx_fmt=info:ofi/fmt:kev:mtx:ctx&ctx_ver=Z39.88-2004&ctx_tim=2022-03-20T13:46:04-04:00&ctx_id=&ctx_enc=info:ofi/enc:UTF-8&rft.atitle=Health-related+quality+of+life,+mental+health+and+psychotherapeutic+considerations+for+women+diagnosed+with+a+disorder+of+sexual+development:+congenital+adrenal+hyperplasia&rft.date=2010&rft.doi=10.1155/2010/253465&rft.eissn=1687-9856&rft.epage=11&rft.genre=article&rft.issn=16879848&rft.issue=1&rft.issue_start=1&rft.jtitle=International+Journal+of+Pediatric+Endocrinology&rft.language=fre&rft.lccn=++2009243825&rft.object_id=1000000000714452&rft.place=[Cairo]&rft.pub=BioMed+Central+Ltd&rft.spage=253465&rft.stitle=INT+J+PEDIATR+ENDOCRINOL&rft.title=International+Journal+of+Pediatric+Endocrinology&rft.volume=2010&rft.volume_start=2010&rft.au=Malouf,+Matthew+A&rft.aulast=Malouf&rft.aufirst=Matthew&rft.auinit=MA&rft.auinitm=A&rft_val_fmt=info:ofi/fmt:kev:mtx:journal&rft_id=info:doi/10.1155/2010/253465&rfr_id=info:sid/google",Article | Health-related quality of life mental health and psychotherapeutic considerations for women diagnosed with a disorder of sexual development congenital adrenal hyperplasia | Malouf Matthew A 2010 | Published in Journal International Journal of Pediatric Endocrinology Volume 2010 Issue 1 Page 253465 11. | ISSN:1687-9848,4,1,1,5,5,10,50,50,0,0,0,0,0
"getit.library.nyu.edu/resolve?forcedownload=1&umlaut.referent_id=18907602&url_ver=Z39.88-2004&url_ctx_fmt=info:ofi/fmt:kev:mtx:ctx&ctx_ver=Z39.88-2004&ctx_tim=2022-03-31T10:48:10-04:00&ctx_id=&ctx_enc=info:ofi/enc:UTF-8&rft.atitle=Childhood+sexuality:+a+decade+of+study.+Part+I\u2014research+and+curriculum+development1&rft.au=Ryan,+Gail&rft.aufirst=Gail&rft.auinit=G&rft.aulast=Ryan&rft.coden=CABND3&rft.date=2000&rft.doi=10.1016/S0145-2134(99)00118-0&rft.eissn=1873-7757&rft.epage=48&rft.genre=article&rft.issn=0145-2134&rft.issue=1&rft.issue_start=1&rft.jtitle=Child+abuse+&+neglect=&rft.language=fre&rft.lccn=++2002238896&rft.month=1&rft.object_id=954925473399&rft.oclcnum=3475531&rft.place=UNITED+STATES&rft.pub=Pergamon+Press&rft.spage=33&rft.stitle=CHILD+ABUSE+AND+NEGLECT&rft.title=Child+abuse+&+neglect=&rft.volume=24&rft.volume_start=24&rft_val_fmt=info:ofi/fmt:kev:mtx:journal&rft_id=info:doi/10.1016/S0145-2134(99)00118-0&rfr_id=info:sid/google",Article | Childhood sexuality a decade of study Part I\u2014research and curriculum development1 | Ryan Gail 2000 | Published in Journal Child abuse Volume 24 Issue 1 Page 33 48. | ISSN:0145-2134,1,0,0,1,1,2,50,50,0,0,0,0,0
"getit.library.nyu.edu/resolve?forcedownload=1&umlaut.referent_id=18907602&url_ver=Z39.88-2004&url_ctx_fmt=info:ofi/fmt:kev:mtx:ctx&ctx_ver=Z39.88-2004&ctx_tim=2022-03-31T20:06:48-04:00&ctx_id=&ctx_enc=info:ofi/enc:UTF-8&rft.atitle=Childhood+sexuality:+a+decade+of+study.+Part+I\u2014research+and+curriculum+development1&rft.au=Ryan,+Gail&rft.aufirst=Gail&rft.auinit=G&rft.aulast=Ryan&rft.coden=CABND3&rft.date=2000&rft.doi=10.1016/S0145-2134(99)00118-0&rft.eissn=1873-7757&rft.epage=48&rft.genre=article&rft.issn=0145-2134&rft.issue=1&rft.issue_start=1&rft.jtitle=Child+abuse+&+neglect=&rft.language=fre&rft.lccn=++2002238896&rft.month=1&rft.object_id=954925473399&rft.oclcnum=3475531&rft.place=UNITED+STATES&rft.pub=Pergamon+Press&rft.spage=33&rft.stitle=CHILD+ABUSE+AND+NEGLECT&rft.title=Child+abuse+&+neglect=&rft.volume=24&rft.volume_start=24&rft_val_fmt=info:ofi/fmt:kev:mtx:journal&rft_id=info:doi/10.1016/S0145-2134(99)00118-0&rfr_id=info:sid/google",Article | Childhood sexuality a decade of study Part I\u2014research and curriculum development1 | Ryan Gail 2000 | Published in Journal Child abuse Volume 24 Issue 1 Page 33 48. | ISSN:0145-2134,0,0,1,0,1,1,0,100,0,0,0,0,0
"getit.library.nyu.edu/resolve?forcedownload=1&umlaut.referent_id=18909986&url_ver=Z39.88-2004&url_ctx_fmt=info:ofi/fmt:kev:mtx:ctx&ctx_ver=Z39.88-2004&ctx_tim=2022-03-31T19:11:31-04:00&ctx_id=&ctx_enc=info:ofi/enc:UTF-8&rft.atitle=Health-related+quality+of+life,+mental+health+and+psychotherapeutic+considerations+for+women+diagnosed+with+a+disorder+of+sexual+development:+congenital+adrenal+hyperplasia&rft.date=2010&rft.doi=10.1155/2010/253465&rft.eissn=1687-9856&rft.epage=11&rft.genre=article&rft.issn=16879848&rft.issue=1&rft.issue_start=1&rft.jtitle=International+Journal+of+Pediatric+Endocrinology&rft.language=fre&rft.lccn=++2009243825&rft.object_id=1000000000714452&rft.place=[Cairo]&rft.pub=BioMed+Central+Ltd&rft.spage=253465&rft.stitle=INT+J+PEDIATR+ENDOCRINOL&rft.title=International+Journal+of+Pediatric+Endocrinology&rft.volume=2010&rft.volume_start=2010&rft.au=Malouf,+Matthew+A&rft.aulast=Malouf&rft.aufirst=Matthew&rft.auinit=MA&rft.auinitm=A&rft_val_fmt=info:ofi/fmt:kev:mtx:journal&rft_id=info:doi/10.1155/2010/253465&rfr_id=info:sid/google",Article | Health-related quality of life mental health and psychotherapeutic considerations for women diagnosed with a disorder of sexual development congenital adrenal hyperplasia | Malouf Matthew A 2010 | Published in Journal International Journal of Pediatric Endocrinology Volume 2010 Issue 1 Page 253465 11. | ISSN:1687-9848,0,0,5,0,5,5,0,100,0,0,0,0,0
"getit.library.nyu.edu/resolve?forcedownload=1&umlaut.referent_id=18929672&url_ver=Z39.88-2004&url_ctx_fmt=info:ofi/fmt:kev:mtx:ctx&ctx_ver=Z39.88-2004&ctx_tim=2022-04-15T11:22:15-04:00&ctx_id=&ctx_enc=info:ofi/enc:UTF-8&rft.atitle=Health-related+quality+of+life,+mental+health+and+psychotherapeutic+considerations+for+women+diagnosed+with+a+disorder+of+sexual+development:+congenital+adrenal+hyperplasia&rft.au=Malouf,+Matthew+A&rft.aufirst=Matthew&rft.auinit=MA&rft.auinitm=A&rft.aulast=Malouf&rft.date=2010&rft.doi=10.1155/2010/253465&rft.eissn=1687-9856&rft.epage=11&rft.genre=article&rft.issn=1687-9848&rft.issue=1&rft.issue_start=1&rft.jtitle=International+Journal+of+Pediatric+Endocrinology&rft.language=fre&rft.lccn=++2009243825&rft.object_id=1000000000714452&rft.place=[Cairo]&rft.pub=BioMed+Central+Ltd&rft.spage=253465&rft.stitle=INT+J+PEDIATR+ENDOCRINOL&rft.title=International+Journal+of+Pediatric+Endocrinology&rft.volume=2010&rft.volume_start=2010&rft_val_fmt=info:ofi/fmt:kev:mtx:journal&rft_id=info:doi/10.1155/2010/253465&rfr_id=info:sid/google",Article | Health-related quality of life mental health and psychotherapeutic considerations for women diagnosed with a disorder of sexual development congenital adrenal hyperplasia | Malouf Matthew A 2010 | Published in Journal International Journal of Pediatric Endocrinology Volume 2010 Issue 1 Page 253465 11. | ISSN:1687-9848,0,0,5,0,5,5,0,100,0,0,0,0,0
"getit.library.nyu.edu/resolve?forcedownload=1&umlaut.referent_id=18929672&url_ver=Z39.88-2004&url_ctx_fmt=info:ofi/fmt:kev:mtx:ctx&ctx_ver=Z39.88-2004&ctx_tim=2022-04-15T11:22:42-04:00&ctx_id=&ctx_enc=info:ofi/enc:UTF-8&rft.atitle=Health-related+quality+of+life,+mental+health+and+psychotherapeutic+considerations+for+women+diagnosed+with+a+disorder+of+sexual+development:+congenital+adrenal+hyperplasia&rft.au=Malouf,+Matthew+A&rft.aufirst=Matthew&rft.auinit=MA&rft.auinitm=A&rft.aulast=Malouf&rft.date=2010&rft.doi=10.1155/2010/253465&rft.eissn=1687-9856&rft.epage=11&rft.genre=article&rft.issn=1687-9848&rft.issue=1&rft.issue_start=1&rft.jtitle=International+Journal+of+Pediatric+Endocrinology&rft.language=fre&rft.lccn=++2009243825&rft.object_id=1000000000714452&rft.place=[Cairo]&rft.pub=BioMed+Central+Ltd&rft.spage=253465&rft.stitle=INT+J+PEDIATR+ENDOCRINOL&rft.title=International+Journal+of+Pediatric+Endocrinology&rft.volume=2010&rft.volume_start=2010&rft_val_fmt=info:ofi/fmt:kev:mtx:journal&rft_id=info:doi/10.1155/2010/253465&rfr_id=info:sid/google",Article | Health-related quality of life mental health and psychotherapeutic considerations for women diagnosed with a disorder of sexual development congenital adrenal hyperplasia | Malouf Matthew A 2010 | Published in Journal International Journal of Pediatric Endocrinology Volume 2010 Issue 1 Page 253465 11. | ISSN:1687-9848,4,1,1,5,5,10,50,50,0,0,0,0,0
"getit.library.nyu.edu/resolve?forcedownload=1&umlaut.referent_id=18938051&url_ver=Z39.88-2004&url_ctx_fmt=info:ofi/fmt:kev:mtx:ctx&ctx_ver=Z39.88-2004&ctx_tim=2022-04-15T15:12:50-04:00&ctx_id=&ctx_enc=info:ofi/enc:UTF-8&rft.atitle=Standards+of+care+for+the+health+of+transsexual,+transgender,+and+gender-nonconforming+people,+version+7&rft.au=Coleman,+E&rft.auinit=E&rft.aulast=Coleman&rft.date=2012&rft.doi=10.1080/15532739.2011.700873&rft.eissn=1434-4599&rft.epage=232&rft.genre=article&rft.issn=1553-2739&rft.issue=4&rft.issue_start=4&rft.jtitle=International+journal+of+transgenderism&rft.language=fre&rft.lccn=+++00253291+&rft.month=08&rft.object_id=991042723500904&rft.place=Du\u0308sseldorf,+Germany&rft.pub=Symposion+Pub.&rft.spage=165&rft.stitle=INTERNATIONAL+JOURNAL+OF+TRANSGENDERISM&rft.title=International+journal+of+transgenderism&rft.volume=13&rft.volume_start=13&rft_val_fmt=info:ofi/fmt:kev:mtx:journal&rft_id=info:doi/10.1080/15532739.2011.700873&rfr_id=info:sid/google",Article | Standards of care for the health of transsexual transgender and gender-nonconforming people version 7 | Coleman E 2012 | Published in Journal International journal of transgenderism Volume 13 Issue 4 Page 165 232. | ISSN:1553-2739,2,0,0,2,2,4,50,50,0,0,0,0,0
"getit.library.nyu.edu/resolve?forcedownload=1&umlaut.referent_id=18957158&url_ver=Z39.88-2004&url_ctx_fmt=info:ofi/fmt:kev:mtx:ctx&ctx_ver=Z39.88-2004&ctx_tim=2022-04-26T17:46:20-04:00&ctx_id=&ctx_enc=info:ofi/enc:UTF-8&rft.atitle=Standards+of+care+for+the+health+of+transsexual,+transgender,+and+gender-nonconforming+people,+version+7&rft.au=Coleman,+E&rft.auinit=E&rft.aulast=Coleman&rft.date=2012&rft.doi=10.1080/15532739.2011.700873&rft.eissn=1434-4599&rft.epage=232&rft.genre=article&rft.issn=1553-2739&rft.issue=4&rft.issue_start=4&rft.jtitle=International+journal+of+transgenderism&rft.language=fre&rft.lccn=+++00253291+&rft.month=08&rft.object_id=991042723500904&rft.place=Du\u0308sseldorf,+Germany&rft.pub=Symposion+Pub.&rft.spage=165&rft.stitle=INTERNATIONAL+JOURNAL+OF+TRANSGENDERISM&rft.title=International+journal+of+transgenderism&rft.volume=13&rft.volume_start=13&rft_val_fmt=info:ofi/fmt:kev:mtx:journal&rft_id=info:doi/10.1080/15532739.2011.700873&rfr_id=info:sid/google",Article | Standards of care for the health of transsexual transgender and gender-nonconforming people version 7 | Coleman E 2012 | Published in Journal International journal of transgenderism Volume 13 Issue 4 Page 165 232. | ISSN:1553-2739,0,0,2,0,2,2,0,100,0,0,0,0,0
"getit.library.nyu.edu/resolve?forcedownload=1&umlaut.referent_id=18957159&url_ver=Z39.88-2004&url_ctx_fmt=info:ofi/fmt:kev:mtx:ctx&ctx_ver=Z39.88-2004&ctx_tim=2022-04-28T18:12:09-04:00&ctx_id=&ctx_enc=info:ofi/enc:UTF-8&rft.atitle=Stress+and+puberty-related+hormone+reactivity,+negative+emotionality,+and+parent\u2013adolescent+relationships&rft.au=Marceau,+Kristine&rft.aufirst=Kristine&rft.auinit=K&rft.aulast=Marceau&rft.coden=PSYCDE&rft.date=2012&rft.doi=10.1016/j.psyneuen.2012.01.001&rft.eissn=1873-3360&rft.epage=1298&rft.genre=article&rft.issn=0306-4530&rft.issue=8&rft.issue_start=8&rft.jtitle=Psychoneuroendocrinology&rft.language=fre&rft.lccn=sn+80008491+&rft.month=08&rft.object_id=954925514499&rft.oclcnum=1343872&rft.place=ENGLAND&rft.pub=Pergamon+Press&rft.spage=1286&rft.stitle=PSYCHONEUROENDOCRINO&rft.title=Psychoneuroendocrinology&rft.volume=37&rft.volume_start=37&rft_val_fmt=info:ofi/fmt:kev:mtx:journal&rft_id=info:doi/10.1016/j.psyneuen.2012.01.001&rfr_id=info:sid/google",Article | Stress and puberty-related hormone reactivity negative emotionality and parent\u2013adolescent relationships | Marceau Kristine 2012 | Published in Journal Psychoneuroendocrinology Volume 37 Issue 8 Page 1286 1298. | ISSN:0306-4530,1,0,0,1,1,2,50,50,0,0,0,0,0
"getit.library.nyu.edu/resolve?forcedownload=1&umlaut.referent_id=18967379&url_ver=Z39.88-2004&url_ctx_fmt=info:ofi/fmt:kev:mtx:ctx&ctx_ver=Z39.88-2004&ctx_tim=2022-04-29T12:07:25-04:00&ctx_id=&ctx_enc=info:ofi/enc:UTF-8&rft.atitle=The+From+Survivor+to+Thriver+program:+RCT+of+an+online+therapist-facilitated+program+for+rape-related+PTSD&rft.coden=JADIE8&rft.date=2016&rft.doi=10.1016/j.janxdis.2016.07.010&rft.eissn=1873-7897&rft.epage=51&rft.genre=article&rft.issn=08876185&rft.jtitle=Journal+of+anxiety+disorders&rft.language=fre&rft.lccn=++2004233010&rft.month=10&rft.object_id=954925553398&rft.place=UNITED+STATES&rft.pub=Pergamon&rft.spage=41&rft.stitle=J+ANXIETY+DISORDERS&rft.title=Journal+of+anxiety+disorders&rft.volume=43&rft.volume_start=43&rft.au=Littleton,+Heather&rft.aulast=Littleton&rft.aufirst=Heather&rft.auinit=H&rft_val_fmt=info:ofi/fmt:kev:mtx:journal&rft_id=info:doi/10.1016/j.janxdis.2016.07.010&rfr_id=info:sid/google",Article | The From Survivor to Thriver program RCT of an online therapist-facilitated program for rape-related PTSD | Littleton Heather 2016 | Published in Journal Journal of anxiety disorders Volume 43 Page 41 51. | ISSN:0887-6185,1,0,0,1,1,2,50,50,0,0,0,0,0
"getit.library.nyu.edu/resolve?forcedownload=1&umlaut.referent_id=18979131&url_ver=Z39.88-2004&url_ctx_fmt=info:ofi/fmt:kev:mtx:ctx&ctx_ver=Z39.88-2004&ctx_tim=2022-05-05T17:02:32-04:00&ctx_id=&ctx_enc=info:ofi/enc:UTF-8&rft.atitle=Stress+and+puberty-related+hormone+reactivity,+negative+emotionality,+and+parent\u2013adolescent+relationships&rft.coden=PSYCDE&rft.date=2012&rft.doi=10.1016/j.psyneuen.2012.01.001&rft.eissn=1873-3360&rft.epage=1298&rft.genre=article&rft.issn=03064530&rft.issue=8&rft.issue_start=8&rft.jtitle=Psychoneuroendocrinology&rft.language=fre&rft.lccn=sn+80008491+&rft.month=08&rft.object_id=954925514499&rft.place=ENGLAND&rft.pub=Pergamon&rft.spage=1286&rft.stitle=PSYCHONEUROENDOCRINO&rft.title=Psychoneuroendocrinology&rft.volume=37&rft.volume_start=37&rft.au=Marceau,+Kristine&rft.aulast=Marceau&rft.aufirst=Kristine&rft.auinit=K&rft_val_fmt=info:ofi/fmt:kev:mtx:journal&rft_id=info:doi/10.1016/j.psyneuen.2012.01.001&rfr_id=info:sid/google",Article | Stress and puberty-related hormone reactivity negative emotionality and parent\u2013adolescent relationships | Marceau Kristine 2012 | Published in Journal Psychoneuroendocrinology Volume 37 Issue 8 Page 1286 1298. | ISSN:0306-4530,1,0,0,1,1,2,50,50,0,0,0,0,0
"getit.library.nyu.edu/resolve?forcedownload=1&umlaut.referent_id=18987226&url_ver=Z39.88-2004&url_ctx_fmt=info:ofi/fmt:kev:mtx:ctx&ctx_ver=Z39.88-2004&ctx_tim=2022-05-11T11:32:02-04:00&ctx_id=&ctx_enc=info:ofi/enc:UTF-8&rft.atitle=\u201cSexting\u201d+and+Its+Relation+to+Sexual+Activity+and+Sexual+Risk+Behavior+in+a+National+Survey+of+Adolescents&rft.au=Ybarra,+Michele+L&rft.aufirst=Michele&rft.auinit=ML&rft.auinitm=L&rft.aulast=Ybarra&rft.coden=JADHE5&rft.date=2014&rft.doi=10.1016/j.jadohealth.2014.07.012&rft.eissn=1879-1972&rft.epage=764&rft.genre=article&rft.issn=1054-139X&rft.issue=6&rft.issue_start=6&rft.jtitle=Journal+of+adolescent+health&rft.language=fre&rft.lccn=++2004233058&rft.month=12&rft.object_id=954925595525&rft.place=UNITED+STATES&rft.pub=Elsevier&rft.spage=757&rft.stitle=J+ADOLESC+HEALTH&rft.title=Adolescent+Health&rft.volume=55&rft.volume_start=55&rft_val_fmt=info:ofi/fmt:kev:mtx:journal&rft_id=info:doi/10.1016/j.jadohealth.2014.07.012&rfr_id=info:sid/google",Article | \u201cSexting\u201d and Its Relation to Sexual Activity and Sexual Risk Behavior in a National Survey of Adolescents | Ybarra Michele L 2014 | Published in Journal Adolescent Health Volume 55 Issue 6 Page 757 764. | ISSN:1054-139X,1,0,0,1,1,2,50,50,0,0,0,0,0
"getit.library.nyu.edu/resolve?forcedownload=1&umlaut.referent_id=18995468&url_ver=Z39.88-2004&url_ctx_fmt=info:ofi/fmt:kev:mtx:ctx&ctx_ver=Z39.88-2004&ctx_tim=2022-05-15T16:31:32-04:00&ctx_id=&ctx_enc=info:ofi/enc:UTF-8&rft.atitle=Stress+and+puberty-related+hormone+reactivity,+negative+emotionality,+and+parent\u2013adolescent+relationships&rft.coden=PSYCDE&rft.date=2012&rft.doi=10.1016/j.psyneuen.2012.01.001&rft.eissn=1873-3360&rft.epage=1298&rft.genre=article&rft.issn=03064530&rft.issue=8&rft.issue_start=8&rft.jtitle=Psychoneuroendocrinology&rft.language=fre&rft.lccn=sn+80008491+&rft.month=08&rft.object_id=954925514499&rft.place=ENGLAND&rft.pub=Pergamon&rft.spage=1286&rft.stitle=PSYCHONEUROENDOCRINO&rft.title=Psychoneuroendocrinology&rft.volume=37&rft.volume_start=37&rft.au=Marceau,+Kristine&rft.aulast=Marceau&rft.aufirst=Kristine&rft.auinit=K&rft_val_fmt=info:ofi/fmt:kev:mtx:journal&rft_id=info:doi/10.1016/j.psyneuen.2012.01.001&rfr_id=info:sid/google",Article | Stress and puberty-related hormone reactivity negative emotionality and parent\u2013adolescent relationships | Marceau Kristine 2012 | Published in Journal Psychoneuroendocrinology Volume 37 Issue 8 Page 1286 1298. | ISSN:0306-4530,1,0,0,1,1,2,50,50,0,0,0,0,0
"getit.library.nyu.edu/resolve?forcedownload=1&umlaut.referent_id=19006223&url_ver=Z39.88-2004&url_ctx_fmt=info:ofi/fmt:kev:mtx:ctx&ctx_ver=Z39.88-2004&ctx_tim=2022-05-27T20:16:09-04:00&ctx_id=&ctx_enc=info:ofi/enc:UTF-8&rft.atitle=From+gender+identity+disorder+to+gender+identity+creativity:+True+gender+self+child+therapy&rft.coden=JOHOD7&rft.date=2012&rft.doi=10.1080/00918369.2012.653303&rft.eissn=1540-3602&rft.epage=356&rft.genre=article&rft.issn=00918369&rft.issue=3&rft.issue_start=3&rft.jtitle=Journal+of+homosexuality&rft.language=fre&rft.lccn=+++74078295+&rft.month=03&rft.object_id=954925463175&rft.place=UNITED+STATES&rft.pub=Haworth+Press,+Inc.&rft.spage=337&rft.stitle=J+HOMOSEX&rft.title=Journal+of+homosexuality&rft.volume=59&rft.volume_start=59&rft.au=Ehrensaft,+Diane&rft.aulast=Ehrensaft&rft.aufirst=Diane&rft.auinit=D&rft_val_fmt=info:ofi/fmt:kev:mtx:journal&rft_id=info:doi/10.1080/00918369.2012.653303&rfr_id=info:sid/google",Article | From gender identity disorder to gender identity creativity True gender self child therapy | Ehrensaft Diane 2012 | Published in Journal Journal of homosexuality Volume 59 Issue 3 Page 337 356. | ISSN:0091-8369,2,1,0,3,2,5,60,40,0,0,0,0,0
getit.library.nyu.edu/resolve?genre=article&atitle=Introduction&jtitle=Chinese Sociology and Anthropology&title=Chinese Sociology and Anthropology&volume=24&artnum=598d9e3167222b0a61f9f3af&spage=9&date=1991,Article | Introduction | 1991 | Published in Journal Chinese Sociology and Anthropology Volume 24 Page 9. | ISSN:0009-4625,1,0,0,1,1,2,50,50,0,0,0,0,0
getit.library.nyu.edu/resolve?genre=article&id=doi:10.1017/S0305741000035839&sid=literatum:tandf&aulast=Sullivan&aufirst=Michael.&date=1994&atitle=The 1988\u201389 Nanjing Anti-African Protests: Racial Nationalism or National Racism?&jtitle=The China Quarterly&volume=138&spage=438&epage=457,Article | The 1988\u201389 Nanjing Anti-African Protests Racial Nationalism or National Racism? | Sullivan Michael J 1994 | Published in Journal CHINA QUARTERLY Volume 138 Page 438 457. | ISSN:0305-7410,3,0,0,3,3,6,50,50,0,0,0,0,0
getit.library.nyu.edu/resolve?genre=article&id=doi:10.1021/la048425c&sid=literatum:achs&aulast=Jung&aufirst=H.+S.&aulast=Shin&aufirst=H.&aulast=Kim&aufirst=J.+R.&aulast=Kim&aufirst=J.+Y.&aulast=Hong&aufirst=K.+S.&aulast=Lee&aufirst=J.+K.&jtitle=Langmuir&date=2004&volume=20&spage=11732,Article | In Situ Observation of the Stability of Anatase Nanoparticles and Their Transformation to Rutile in an Acidic Solution | Jung Hyun Suk 2004 | Published in Journal LANGMUIR Volume 20 Issue 26 Page 11732 11737. | ISSN:0743-7463,1,0,0,1,1,2,50,50,0,0,0,0,0
getit.library.nyu.edu/resolve?genre=article&id=doi:10.1039/b411545g&sid=literatum:achs&aulast=Diederichsen&aufirst=U.&aulast=Weicherding&aufirst=D.&aulast=Diezemann&aufirst=N.&atitle=Side Chain Homologation of Alanyl Peptide Nucleic Acids: Pairing Selectivity and Stacking&jtitle=Org. Biomol. Chem.&date=2005&volume=3&issue=6&spage=1058&epage=1066&doi=10.1039/b411545g,Article | Side Chain Homologation of Alanyl Peptide Nucleic Acids Pairing Selectivity and Stacking | Diederichsen Ulf 2005 | Published in Journal ORGANIC BIOMOLECULAR CHEMISTRY Volume 3 Issue 6 Page 1058 1066. | ISSN:1477-0520,1,0,0,1,1,2,50,50,0,0,0,0,0
getit.library.nyu.edu/resolve?genre=article&id=doi:10.1126/science.aax8466&sid=literatum:achs&aulast=Tang&aufirst=X.&aulast=Westlie&aufirst=A.+H.&aulast=Watson&aufirst=E.+M.&aulast=Chen&aufirst=E.+Y.-X.&atitle=Stereosequenced crystalline polyhydroxyalkanoates from diastereomeric monomer mixtures&jtitle=Science&date=2019&volume=366&spage=754&epage=758&doi=10.1126/science.aax8466,Article | Stereosequenced crystalline polyhydroxyalkanoates from diastereomeric monomer mixtures | Tang Xiaoyan 2019 | Published in Journal SCIENCE Volume 366 Issue 6466 Page 754 758. | ISSN:0036-8075,2,0,0,2,2,4,50,50,0,0,0,0,0
getit.library.nyu.edu/resolve?genre=article&isbn=&issn=00014826&title=Accounting Review&volume=&issue=&date=&atitle=&aulast=&spage=&sid=EBSCO:Business Source Complete -- Publications&pid=Business Source Complete -- Publications,Article | Accounting Review |  | ISSN:0001-4826 | undefined,0,0,5,0,5,5,0,100,0,0,0,0,0
"getit.library.nyu.edu/resolve?genre=article&isbn=&issn=00018996&title=Advocate&volume=&issue=454&date=19860902&atitle=WAS ROY COHN A GAY QUISLING?&aulast=Giteck, Lenny&spage=5&sid=EBSCO:LGBTQ+ Source&pid=Giteck, Lenny953119219860902LGBTQ+ Source",Article | WAS ROY COHN A GAY QUISLING? | Giteck Lenny 1986 Sep 02 | Published in Journal Advocate Issue 454 Page 5. | ISSN:0001-8996,0,1,1,1,1,2,50,50,0,0,0,0,0
"getit.library.nyu.edu/resolve?genre=article&isbn=&issn=00019720&title=AFRICA&volume=92&issue=1&date=20220101&atitle=Rethinking Achille Mbembe's 'Provisional notes on the postcolony' INTRODUCTION&aulast=Adebanwi, Wale&spage=42&sid=EBSCO:Social Sciences Citation Index&pid=Adebanwi, Wale00074503430000420220101Social Sciences Citation Index",Article | Rethinking Achille Mbembe's Provisional notes on the postcolony INTRODUCTION | Adebanwi Wale 2022 Jan 01 | Published in Journal AFRICA Volume 92 Issue 1 Page 42. | ISSN:0001-9720,5,2,1,7,6,13,54,46,0,0,0,0,0
"getit.library.nyu.edu/resolve?genre=article&isbn=&issn=00027162&title=ANNALS OF THE AMERICAN ACADEMY OF POLITICAL AND SOCIAL SCIENCE&volume=677&issue=1&date=20180501&atitle=Identifying the Later-Generation Descendants of US Immigrants: Issues Arising from Selective Ethnic Attrition&aulast=Duncan, Brian&spage=131&sid=EBSCO:Social Sciences Citation Index&pid=Duncan, Brian00043213200001120180501Social Sciences Citation Index",Article | Identifying the Later-Generation Descendants of US Immigrants Issues Arising from Selective Ethnic Attrition | Duncan Brian 2018 May 01 | Published in Journal ANNALS OF THE AMERICAN ACADEMY OF POLITICAL AND SOCIAL SCIENCE Volume 677 Issue 1 Page 131. | ISSN:0002-7162,5,1,1,6,6,12,50,50,0,0,0,0,0
"getit.library.nyu.edu/resolve?genre=article&isbn=&issn=00029165&title=AMERICAN JOURNAL OF CLINICAL NUTRITION&volume=61&issue=6//SUP&date=&atitle=Mediterranean diet pyramid: a cultural model for healthy eating&aulast=Willett, W. C.&spage=1402S&sid=EBSCO:British Library Document Supply Centre Inside Serials & Conference Proceedings=&pid=Willett, W. C.CN008843909British Library Document Supply Centre Inside Serials & Conference Proceedings=",Article | Mediterranean diet pyramid a cultural model for healthy eating | Willett W C | Published in Journal AMERICAN JOURNAL OF CLINICAL NUTRITION Volume 61 Issue 6 SUP Page 1402S. | ISSN:0002-9165,0,0,4,0,4,4,0,100,0,0,0,0,0
"getit.library.nyu.edu/resolve?genre=article&isbn=&issn=00030007&title=Bulletin of the American Meteorological Society&volume=103&issue=3&date=20220301&atitle=The Integrated Carbon Observation System in Europe.&aulast=Heiskanen, Jouni&spage=E855&sid=EBSCO:General Science Full Text (H.W. Wilson)&pid=Heiskanen, Jouni15619041920220301General Science Full Text (H.W. Wilson)",Article | The Integrated Carbon Observation System in Europe. | Heiskanen Jouni 2022 Mar 01 | Published in Journal Bulletin of the American Meteorological Society Volume 103 Issue 3 Page E855. | ISSN:0003-0007,4,1,0,5,4,9,56,44,0,0,0,0,0
"getit.library.nyu.edu/resolve?genre=article&isbn=&issn=00030554&title=American Political Science Review&volume=113&issue=2&date=20190501&atitle=Local News and National Politics.&aulast=MARTIN, GREGORY J.&spage=372&sid=EBSCO:Social Sciences Full Text (H.W. Wilson)&pid=MARTIN, GREGORY J.13661178320190501Social Sciences Full Text (H.W. Wilson)",Article | Local News and National Politics. | Martin Gregory J 2019 May 01 | Published in Journal American Political Science Review Volume 113 Issue 2 Page 372. | ISSN:0003-0554,3,0,0,3,3,6,50,50,0,0,0,0,0
"getit.library.nyu.edu/resolve?genre=article&isbn=&issn=0003066X&title=AMERICAN PSYCHOLOGIST&volume=55&issue=5&date=20000101&atitle=Emerging Adulthood: A Theory of Development From the Late Teens Through the Twenties&aulast=Arnett, J. J.&spage=469&sid=EBSCO:British Library Document Supply Centre Inside Serials & Conference Proceedings=&pid=Arnett, J. J.RN07887195720000101British Library Document Supply Centre Inside Serials & Conference Proceedings=",Article | Emerging Adulthood A Theory of Development From the Late Teens Through the Twenties | Arnett J J 2000 Jan 01 | Published in Journal AMERICAN PSYCHOLOGIST Volume 55 Issue 5 Page 469. | ISSN:0003-066X,1,0,0,1,1,2,50,50,0,0,0,0,0
"getit.library.nyu.edu/resolve?genre=article&isbn=&issn=0003066X&title=AMERICAN PSYCHOLOGIST&volume=67&issue=2&date=20120101&atitle=Beyond Positive Psychology? Toward a Contextual View of Psychological Processes and Well-Being&aulast=McNulty, J.K.&spage=101&sid=EBSCO:British Library Document Supply Centre Inside Serials & Conference Proceedings=&pid=McNulty, J.K.RN30796781720120101British Library Document Supply Centre Inside Serials & Conference Proceedings=",Article | Beyond Positive Psychology Toward a Contextual View of Psychological Processes and Well-Being | McNulty J K 2012 Jan 01 | Published in Journal AMERICAN PSYCHOLOGIST Volume 67 Issue 2 Page 101. | ISSN:0003-066X,1,0,0,1,1,2,50,50,0,0,0,0,0
"getit.library.nyu.edu/resolve?genre=article&isbn=&issn=0003066X&title=American psychologist&volume=74&issue=1&date=20190101&atitle=Disarming Racial Microaggressions: Microintervention Strategies for Targets, White Allies, and Bystanders&aulast=Sue, Derald Wing&spage=128&sid=EBSCO:British Library Document Supply Centre Inside Serials & Conference Proceedings=&pid=Sue, Derald WingRN61904721720190101British Library Document Supply Centre Inside Serials & Conference Proceedings=",Article | Disarming Racial Microaggressions Microintervention Strategies for Targets White Allies and Bystanders | Sue Derald Wing 2019 Jan 01 | Published in Journal American psychologist Volume 74 Issue 1 Page 128. | ISSN:0003-066X,0,0,1,0,1,1,0,100,0,0,0,0,0
"getit.library.nyu.edu/resolve?genre=article&isbn=&issn=00030678&title=AMERICAN QUARTERLY&volume=71&issue=2&date=20190601&atitle=Boyle Heights and the fight against gentrification as state violence&aulast=O'Brien, Kean&spage=389&sid=EBSCO:Chicano Database&pid=O'Brien, KeanXCHD8303320190601Chicano Database",Article | Boyle Heights and the fight against gentrification as state violence | O'Brien Kean 2019 Jun 01 | Published in Journal AMERICAN QUARTERLY Volume 71 Issue 2 Page 389. | ISSN:0003-0678,4,0,0,4,4,8,50,50,0,0,0,0,0
"getit.library.nyu.edu/resolve?genre=article&isbn=&issn=00030996&title=American Scientist&volume=109&issue=6&date=20211101&atitle=Artists as Archeologists of Wildfire.&aulast=Chianese, Robert Louis&spage=346&sid=EBSCO:Academic Search Complete&pid=Chianese, Robert Louis15299798320211101Academic Search Complete",Article | Artists as Archeologists of Wildfire. | Chianese Robert Louis 2021 Nov 01 | Published in Journal American Scientist Volume 109 Issue 6 Page 346. | ISSN:0003-0996,5,1,0,6,5,11,55,45,0,0,0,0,0
"getit.library.nyu.edu/resolve?genre=article&isbn=&issn=00030996&title=American scientist&volume=108&issue=4&date=20200101&atitle=Can AI Be Truly Creative?&aulast=Miller, Arthur I.&spage=244&sid=EBSCO:British Library Document Supply Centre Inside Serials & Conference Proceedings=&pid=Miller, Arthur I.RN62408953220200101British Library Document Supply Centre Inside Serials & Conference Proceedings=",Article | Can AI Be Truly Creative? | Miller Arthur I 2020 Jan 01 | Published in Journal American scientist Volume 108 Issue 4 Page 244. | ISSN:0003-0996,5,1,0,6,5,11,55,45,0,0,0,0,0
"getit.library.nyu.edu/resolve?genre=article&isbn=&issn=00037583&title=Ararat: Quarterly Journal of Armenian Literature, History and the Arts&volume=42&issue=4&date=20010101&atitle=A Modern Epic&aulast=Sarafian, Arpi&spage=48&sid=EBSCO:American Bibliography of Slavic, East European, and Eurasian Studies&pid=Sarafian, Arpi5512620010101American Bibliography of Slavic, East European, and Eurasian Studies",Article | A Modern Epic | Sarafian Arpi 2001 Jan 01 | Published in Journal Ararat Quarterly Journal of Armenian Literature History and the Arts Volume 42 Issue 4 Page 48. | ISSN:0003-7583,1,0,0,1,1,2,50,50,0,0,0,0,0
"getit.library.nyu.edu/resolve?genre=article&isbn=&issn=00040002&title=Archives of Sexual Behavior&volume=50&issue=4&date=20210501&atitle=Internalized Consensual Non-Monogamy Negativity and Relationship Quality Among People Engaged in Polyamory, Swinging, and Open Relationships.&aulast=Moors, Amy C.&spage=1389&sid=EBSCO:Social Sciences Full Text (H.W. Wilson)&pid=Moors, Amy C.15097322620210501Social Sciences Full Text (H.W. Wilson)",Article | Internalized Consensual Non-Monogamy Negativity and Relationship Quality Among People Engaged in Polyamory Swinging and Open Relationships. | Moors Amy C 2021 May 01 | Published in Journal Archives of Sexual Behavior Volume 50 Issue 4 Page 1389. | ISSN:0004-0002,4,1,0,5,4,9,56,44,0,0,0,0,0
"getit.library.nyu.edu/resolve?genre=article&isbn=&issn=00040002&title=Archives of Sexual Behavior&volume=50&issue=8&date=20211101&atitle=Makeup and Its Application Simulation Affect Women's Self-Perceptions.&aulast=Anchieta, Nat\u00e1lia Machado&spage=3777&sid=EBSCO:Social Sciences Full Text (H.W. Wilson)&pid=Anchieta, Nat\u00e1lia Machado15368227320211101Social Sciences Full Text (H.W. Wilson)",Article | Makeup and Its Application Simulation Affect Women's Self-Perceptions. | Anchieta Natu00e1lia Machado 2021 Nov 01 | Published in Journal Archives of Sexual Behavior Volume 50 Issue 8 Page 3777. | ISSN:0004-0002,4,1,0,5,4,9,56,44,0,0,0,0,0
"getit.library.nyu.edu/resolve?genre=article&isbn=&issn=00040975&title=ARETHUSA&volume=54&issue=2&date=20210101&atitle=Justice, Revenge, and Unexpected Theodicy in Lars Von Trier's Dogville and Euripides' Medea&aulast=Haller, Benjamin Stephen&spage=221&sid=EBSCO:Arts & Humanities Citation Index=&pid=Haller, Benjamin Stephen00073790920000420210101Arts & Humanities Citation Index=",Article | Justice Revenge and Unexpected Theodicy in Lars Von Trier's Dogville and Euripides Medea | Haller Benjamin Stephen 2021 Jan 01 | Published in Journal ARETHUSA Volume 54 Issue 2 Page 221. | ISSN:0004-0975,2,0,0,2,2,4,50,50,0,0,0,0,0
"getit.library.nyu.edu/resolve?genre=article&isbn=&issn=00040975&title=Arethusa&volume=51&issue=2&date=20180401&atitle=Utopia and Uneven Space in Wole Soyinka's The Bacchae of Euripides.&aulast=Gabriel, Kay&spage=163&sid=EBSCO:Complementary Index&pid=Gabriel, Kay13129047320180401Complementary Index",Article | Utopia and Uneven Space in Wole Soyinka's The Bacchae of Euripides. | Gabriel Kay 2018 Apr 01 | Published in Journal Arethusa Volume 51 Issue 2 Page 163. | ISSN:0004-0975,2,0,0,2,2,4,50,50,0,0,0,0,0
"getit.library.nyu.edu/resolve?genre=article&isbn=&issn=00043214&title=Art in America&volume=71&issue=&date=19830101&atitle=Evening on Karl Johan Street (1892)&aulast=Munch, Edvard&spage=66&sid=EBSCO:Art Index Retrospective (H.W. Wilson)&pid=Munch, Edvard51365919919830101Art Index Retrospective (H.W. Wilson)",Article | Evening on Karl Johan Street 1892) | Munch Edvard 1983 Jan 01 | Published in Journal Art in America Volume 71 Page 66. | ISSN:0004-3214,1,0,0,1,1,2,50,50,0,0,0,0,0
"getit.library.nyu.edu/resolve?genre=article&isbn=&issn=00044717&title=Asiatische Studien/Etudes Asiatiques: Zeitschrift der Schweizerischen Asiengesellschaft/Revue de la Soci\u00e9t\u00e9 Suisse-Asie&volume=3&issue=3&date=19980101&atitle=Shamanism, Death, and the Ancestors: Religious Mediation in Neolithic and Shang China (ca. 5000-1000 B.C.)&aulast=Keightley, David N.&spage=763&sid=EBSCO:MLA International Bibliography&pid=Keightley, David N.200142029719980101MLA International Bibliography",Article | Shamanism Death and the Ancestors Religious Mediation in Neolithic and Shang China ca 5000-1000 B.C  | Keightley David N 1998 Jan 01 | Published in Journal Asiatische Studien/Etudes Asiatiques Zeitschrift der Schweizerischen Asiengesellschaft/Revue de la Soci\u00e9t\u00e9 Suisse-Asie Volume 3 Issue 3 Page 763. | ISSN:0004-4717,1,0,0,1,1,2,50,50,0,0,0,0,0
getit.library.nyu.edu/resolve?genre=article&isbn=&issn=0004637X&title=Astrophysical Journal&volume=927&issue=1&date=20220301&atitle=The (Black Hole Mass)\u00e2\u20ac\,Article | The Black Hole Mass u00e2\u20ac\ | 2022 Mar 01 | Published in Journal Astrophysical Journal Volume 927 Issue 1. | ISSN:0004-637X,2,0,0,2,2,4,50,50,0,0,0,0,0
"getit.library.nyu.edu/resolve?genre=article&isbn=&issn=00052604&title=AZTLA\u0301N&volume=29&issue=2&date=20040101&atitle=Fountain of youth&aulast=Noriega, Chon A.&spage=1&sid=EBSCO:Chicano Database&pid=Noriega, Chon A.XCHD6913820040101Chicano Database",Article | Fountain of youth | Noriega Chon A 2004 Jan 01 | Published in Journal AZTLA\u0301N Volume 29 Issue 2 Page 1. | ISSN:0005-2604,1,0,0,1,1,2,50,50,0,0,0,0,0
"getit.library.nyu.edu/resolve?genre=article&isbn=&issn=00052604&title=AZTLA\u0301N&volume=36&issue=1&date=20110101&atitle=Book review of: CHICANA SEXUALITY AND GENDER: CULTURAL REFIGURING IN LITERATURE, ORAL HISTORY, AND ART&aulast=Cook, Christi&spage=233&sid=EBSCO:Chicano Database&pid=Cook, ChristiXCHD7173320110101Chicano Database",Article | Book review of CHICANA SEXUALITY AND GENDER CULTURAL REFIGURING IN LITERATURE ORAL HISTORY AND ART | Cook Christi 2011 Jan 01 | Published in Journal AZTLA\u0301N Volume 36 Issue 1 Page 233. | ISSN:0005-2604,1,0,0,1,1,2,50,50,0,0,0,0,0
"getit.library.nyu.edu/resolve?genre=article&isbn=&issn=00076813&title=BUSINESS HORIZONS&volume=64&issue=4&date=20210701&atitle=Will AI ever sit at the C-suite table? The future of senior leadership&aulast=Watson, Graeme J.&spage=465&sid=EBSCO:Social Sciences Citation Index&pid=Watson, Graeme J.00066125850000820210701Social Sciences Citation Index",Article | Will AI ever sit at the C-suite table The future of senior leadership | Watson Graeme J 2021 Jul 01 | Published in Journal BUSINESS HORIZONS Volume 64 Issue 4 Page 465. | ISSN:0007-6813,1,0,0,1,1,2,50,50,0,0,0,0,0
"getit.library.nyu.edu/resolve?genre=article&isbn=&issn=00078069&title=CEA Critic&volume=78&issue=3&date=20161101&atitle=No Rest for the Wicked: Immoral Implications of Insanity and Sleeplessness in Jane Eyre.&aulast=STROVAS, KAREN BETH&spage=384&sid=EBSCO:Humanities Source&pid=STROVAS, KAREN BETH12167034720161101Humanities Source",Article | No Rest for the Wicked Immoral Implications of Insanity and Sleeplessness in Jane Eyre. | Strovas Karen Beth 2016 Nov 01 | Published in Journal CEA Critic Volume 78 Issue 3 Page 384. | ISSN:0007-8069,3,0,0,3,3,6,50,50,0,0,0,0,0
"getit.library.nyu.edu/resolve?genre=article&isbn=&issn=00093920&title=Child Development&volume=92&issue=4&date=20210701&atitle=More Later: Delay of Gratification and Thought About the Future in Children.&aulast=Burns, Patrick&spage=1554&sid=EBSCO:Social Sciences Full Text (H.W. Wilson)&pid=Burns, Patrick15181699520210701Social Sciences Full Text (H.W. Wilson)",Article | More Later Delay of Gratification and Thought About the Future in Children. | Burns Patrick 2021 Jul 01 | Published in Journal Child Development Volume 92 Issue 4 Page 1554. | ISSN:0009-3920,2,2,0,4,2,6,67,33,0,0,0,0,0
"getit.library.nyu.edu/resolve?genre=article&isbn=&issn=00093920&title=Child Development&volume=92&issue=5&date=20210901&atitle=Prenatal Neighborhood Ethnocultural Context and the Mental Health of Mothers and Children in Low\u2010Income Mexican American Families.&aulast=Curci, Sarah G.&spage=1785&sid=EBSCO:Academic Search Complete&pid=Curci, Sarah G.15265335120210901Academic Search Complete",Article | Prenatal Neighborhood Ethnocultural Context and the Mental Health of Mothers and Children in Low\u2010Income Mexican American Families. | Curci Sarah G 2021 Sep 01 | Published in Journal Child Development Volume 92 Issue 5 Page 1785. | ISSN:0009-3920,2,2,0,4,2,6,67,33,0,0,0,0,0
"getit.library.nyu.edu/resolve?genre=article&isbn=&issn=00094978&title=Choice: Current Reviews for Academic Libraries&volume=57&issue=4&date=20191201&atitle=Dubious pundits: presidential politics, latenight comedy, and the public sphere.&aulast=O'Connor, R. E.&spage=484&sid=EBSCO:Supplemental Index&pid=O'Connor, R. E.13982492820191201Supplemental Index",Article | Dubious pundits presidential politics latenight comedy and the public sphere. | O'Connor R E 2019 Dec 01 | Published in Journal Choice Current Reviews for Academic Libraries Volume 57 Issue 4 Page 484. | ISSN:0009-4978,3,0,0,3,3,6,50,50,0,0,0,0,0
"getit.library.nyu.edu/resolve?genre=article&isbn=&issn=00095982&title=Chronicle of Higher Education&volume=58&issue=29&date=20120323&atitle=The Case Against the Case Against Free Will.&aulast=MELE, ALFRED R.&spage=B7&sid=EBSCO:Academic Search Complete&pid=MELE, ALFRED R.7381232520120323Academic Search Complete",Article | The Case Against the Case Against Free Will. | Mele Alfred R 2012 Mar 23 | Published in Journal Chronicle of Higher Education Volume 58 Issue 29 Page B7. | ISSN:0009-5982,7,1,0,8,7,15,53,47,0,0,0,0,0
"getit.library.nyu.edu/resolve?genre=article&isbn=&issn=00103330&title=Commonweal&volume=110&issue=&date=19830101&atitle=Uncorking neo-prohibition&aulast=Luks, Allan&spage=426&sid=EBSCO:Atla Religion Database&pid=Luks, AllanCPLI000019681019830101Atla Religion Database",Article | Uncorking neo-prohibition | Luks Allan 1983 Jan 01 | Published in Journal Commonweal Volume 110 Page 426. | ISSN:0010-3330,1,0,0,1,1,2,50,50,0,0,0,0,0
"getit.library.nyu.edu/resolve?genre=article&isbn=&issn=00103616&title=COMMUNICATIONS IN MATHEMATICAL PHYSICS&volume=174&issue=1&date=19950101&atitle=Complexity of Trajectories in Rectangular Billiards&aulast=Baryshnikov, Y.&spage=43&sid=EBSCO:British Library Document Supply Centre Inside Serials & Conference Proceedings=&pid=Baryshnikov, Y.RN00052061519950101British Library Document Supply Centre Inside Serials & Conference Proceedings=",Article | Complexity of Trajectories in Rectangular Billiards | Baryshnikov Y 1995 Jan 01 | Published in Journal COMMUNICATIONS IN MATHEMATICAL PHYSICS Volume 174 Issue 1 Page 43. | ISSN:0010-3616,1,1,1,2,2,4,50,50,0,0,0,0,0
getit.library.nyu.edu/resolve?genre=article&isbn=&issn=00104124&title=Comparative Literature&volume=15&issue=4&date=19631001&atitle=Nj\u00e1ls Saga and the Western Literary Tradition&aulast=Denton Fox&spage=289&sid=EBSCO:JSTOR Journals&pid=Denton Foxedsjsr.10.2307.176941219631001JSTOR Journals,Article | Nj\u00e1ls Saga and the Western Literary Tradition | Denton Fox 1963 Oct 01 | Published in Journal Comparative Literature Volume 15 Issue 4 Page 289. | ISSN:0010-4124,2,0,0,2,2,4,50,50,0,0,0,0,0
"getit.library.nyu.edu/resolve?genre=article&isbn=&issn=00122157&title=Dialogue: A Journal of Mormon Thought&volume=29&issue=2&date=19960701&atitle=They Eat Dogs in China&aulast=Liu, Timothy&spage=154&sid=EBSCO:JSTOR Journals&pid=Liu, Timothyedsjsr.10.2307.4522620219960701JSTOR Journals",Article | They Eat Dogs in China | Liu Timothy 1996 Jul 01 | Published in Journal Dialogue A Journal of Mormon Thought Volume 29 Issue 2 Page 154. | ISSN:0012-2157,1,1,1,2,2,4,50,50,0,0,0,0,0
"getit.library.nyu.edu/resolve?genre=article&isbn=&issn=00125768&title=DownBeat&volume=84&issue=1&date=20170101&atitle=1917: The year that gave us Monk, Dizzy, Ella, Buddy & the first jazz records=&aulast=McDonough, John&spage=27&sid=EBSCO:RILM Abstracts of Music Literature with Full Text&pid=McDonough, JohnA121058420170101RILM Abstracts of Music Literature with Full Text",Article | 1917 The year that gave us Monk Dizzy Ella Buddy | McDonough John 2017 Jan 01 | Published in Journal DownBeat Volume 84 Issue 1 Page 27. | ISSN:0012-5768,1,0,0,1,1,2,50,50,0,0,0,0,0
getit.library.nyu.edu/resolve?genre=article&isbn=&issn=0015587X&title=Folklore&volume=126&issue=1&date=20150401&atitle=Grassroots Memorials: The Politics of Memorializing Traumatic Death Peter Jan Margry Cristina S\u00e1nchez-Carretero&aulast=Helen Frisby&spage=102&sid=EBSCO:JSTOR Journals&pid=Helen Frisbyedsjsr.2477441020150401JSTOR Journals,Article | Grassroots Memorials The Politics of Memorializing Traumatic Death Peter Jan Margry Cristina S\u00e1nchez-Carretero | Helen Frisby 2015 Apr 01 | Published in Journal Folklore Volume 126 Issue 1 Page 102. | ISSN:0015-587X,0,0,2,0,2,2,0,100,0,0,0,0,0
"getit.library.nyu.edu/resolve?genre=article&isbn=&issn=00167185&title=Geoforum&volume=43&issue=2&date=20120301&atitle=Against ourselves \u2013 Local activists and the management of contradicting political loyalties: The case of Phiri, Johannesburg&aulast=Matlala, Boitumelo&spage=207&sid=EBSCO:ScienceDirect&pid=Matlala, BoitumeloS001671851100206520120301ScienceDirect",Article | Against ourselves u2013 Local activists and the management of contradicting political loyalties The case of Phiri Johannesburg | Matlala Boitumelo 2012 Mar 01 | Published in Journal Geoforum Volume 43 Issue 2 Page 207. | ISSN:0016-7185,1,0,0,1,1,2,50,50,0,0,0,0,0
"getit.library.nyu.edu/resolve?genre=article&isbn=&issn=00168076&title=George Washington Law Review&volume=86&issue=6&date=20181101&atitle=The Challenge of Race and Crime in a Free Society: The Racial Divide in Fifty Years of Juvenile Justice Reform.&aulast=Henning, Kristin&spage=1604&sid=EBSCO:Legal Source&pid=Henning, Kristin13367728120181101Legal Source",Article | The Challenge of Race and Crime in a Free Society The Racial Divide in Fifty Years of Juvenile Justice Reform. | Henning Kristin 2018 Nov 01 | Published in Journal George Washington Law Review Volume 86 Issue 6 Page 1604. | ISSN:0016-8076,2,1,0,3,2,5,60,40,0,0,0,0,0
"getit.library.nyu.edu/resolve?genre=article&isbn=&issn=00173835&title=Greece & Rome=&volume=66&issue=2&date=20191001&atitle=General.&aulast=Petrovic, Ivana&spage=334&sid=EBSCO:Complementary Index&pid=Petrovic, Ivana13873208720191001Complementary Index",Article | General. | Petrovic Ivana 2019 Oct 01 | Published in Journal Greece Volume 66 Issue 2 Page 334. | ISSN:0017-3835,5,0,0,5,5,10,50,50,0,0,0,0,0
"getit.library.nyu.edu/resolve?genre=article&isbn=&issn=00175749&title=GUT&volume=70&issue=12&date=20211201&atitle=Dietary fibres and IBS: translating functional characteristics to clinical value in the era of personalised medicine&aulast=So, Daniel&spage=2383&sid=EBSCO:Science Citation Index Expanded&pid=So, Daniel00071773170002020211201Science Citation Index Expanded",Article | Dietary fibres and IBS translating functional characteristics to clinical value in the era of personalised medicine | So Daniel 2021 Dec 01 | Published in Journal GUT Volume 70 Issue 12 Page 2383. | ISSN:0017-5749,2,0,0,2,2,4,50,50,0,0,0,0,0
getit.library.nyu.edu/resolve?genre=article&isbn=&issn=00182753&title=History Today&volume=&issue=&date=&atitle=&aulast=&spage=&sid=EBSCO:Academic Search Complete -- Publications&pid=Academic Search Complete -- Publications,Article | History Today |  | ISSN:0018-2753 | undefined,0,0,5,0,5,5,0,100,0,0,0,0,0
"getit.library.nyu.edu/resolve?genre=article&isbn=&issn=00207284&title=INTERNATIONAL JOURNAL OF GROUP PSYCHOTHERAPY&volume=51&issue=3&date=20010101&atitle=Group Process and Group Phenomena on the Internet&aulast=Weinberg, H.&spage=361&sid=EBSCO:British Library Document Supply Centre Inside Serials & Conference Proceedings=&pid=Weinberg, H.RN09835988620010101British Library Document Supply Centre Inside Serials & Conference Proceedings=",Article | Group Process and Group Phenomena on the Internet | Weinberg H 2001 Jan 01 | Published in Journal INTERNATIONAL JOURNAL OF GROUP PSYCHOTHERAPY Volume 51 Issue 3 Page 361. | ISSN:0020-7284,3,0,0,3,3,6,50,50,0,0,0,0,0
"getit.library.nyu.edu/resolve?genre=article&isbn=&issn=00207284&title=International journal of group psychotherapy&volume=68&issue=1&date=20180101&atitle=Group Therapy for Addictions: An Interpersonal Relapse Prevention Approach&aulast=Irabli, Candace&spage=120&sid=EBSCO:British Library Document Supply Centre Inside Serials & Conference Proceedings=&pid=Irabli, Candacevdc.100063170393.0x00000120180101British Library Document Supply Centre Inside Serials & Conference Proceedings=",Article | Group Therapy for Addictions An Interpersonal Relapse Prevention Approach | Irabli Candace 2018 Jan 01 | Published in Journal International journal of group psychotherapy Volume 68 Issue 1 Page 120. | ISSN:0020-7284,1,0,0,1,1,2,50,50,0,0,0,0,0
"getit.library.nyu.edu/resolve?genre=article&isbn=&issn=00207985&title=International Migration&volume=59&issue=3&date=20210601&atitle=At 70, has the 1951 Refugee Convention seen its day?&aulast=\u00c7orabat\u0131r, Metin&spage=245&sid=EBSCO:America: History and Life with Full Text&pid=\u00c7orabat\u0131r, Metin15039095120210601America: History and Life with Full Text",Article | At 70 has the 1951 Refugee Convention seen its day? | U00c7orabatu0131r Metin 2021 Jun 01 | Published in Journal International Migration Volume 59 Issue 3 Page 245. | ISSN:0020-7985,2,0,0,2,2,4,50,50,0,0,0,0,0
"getit.library.nyu.edu/resolve?genre=article&isbn=&issn=00208728&title=International Social Work&volume=51&issue=6&date=20081101&atitle=Exploring the History of Social Work as a Human Rights Profession&aulast=Healy, Lynne M.&spage=735&sid=EBSCO:HeinOnline&pid=Healy, Lynne M.edshol.hein.journals.intsocwk51.7620081101HeinOnline",Article | Exploring the History of Social Work as a Human Rights Profession | Healy Lynne M 2008 Nov 01 | Published in Journal International Social Work Volume 51 Issue 6 Page 735. | ISSN:0020-8728,2,0,0,2,2,4,50,50,0,0,0,0,0
"getit.library.nyu.edu/resolve?genre=article&isbn=&issn=00208728&title=International Social Work&volume=60&issue=3&date=20170101&atitle=Theoretical Dimensions for Interrogating the Intersection of Disability, Immigration and Social Work&aulast=El-Lahib, Yahya&spage=640&sid=EBSCO:HeinOnline&pid=El-Lahib, Yahyaedshol.hein.journals.intsocwk60.5320170101HeinOnline",Article | Theoretical Dimensions for Interrogating the Intersection of Disability Immigration and Social Work | El Lahib Yahya 2017 Jan 01 | Published in Journal International Social Work Volume 60 Issue 3 Page 640. | ISSN:0020-8728,2,0,0,2,2,4,50,50,0,0,0,0,0
"getit.library.nyu.edu/resolve?genre=article&isbn=&issn=00208736&title=International Socialism&volume=&issue=169&date=20211215&atitle=Cedric Robinson, racial capitalism and the return of black radicalism.&aulast=Olende, Ken&spage=149&sid=EBSCO:Alternative Press Index&pid=Olende, KenALTP99864120211215Alternative Press Index",Article | Cedric Robinson racial capitalism and the return of black radicalism. | Olende Ken 2021 Dec 15 | Published in Journal International Socialism Issue 169 Page 149. | ISSN:0020-8736,1,0,0,1,1,2,50,50,0,0,0,0,0
"getit.library.nyu.edu/resolve?genre=article&isbn=&issn=00220078&title=JOURNAL OF CONSUMER AFFAIRS&volume=&issue=&date=20210610&atitle=The shifting landscape of cannabis legalization: Potential benefits and regulatory perspectives&aulast=Newman, Christopher L.&spage=&sid=EBSCO:Social Sciences Citation Index&pid=Newman, Christopher L.00065971260000120210610Social Sciences Citation Index",Article | The shifting landscape of cannabis legalization Potential benefits and regulatory perspectives | Newman Christopher L 2021 Jun 10 | Published in Journal JOURNAL OF CONSUMER AFFAIRS. | ISSN:0022-0078,0,0,2,0,2,2,0,100,0,0,0,0,0
"getit.library.nyu.edu/resolve?genre=article&isbn=&issn=00220167&title=Journal of Counseling Psychology&volume=60&issue=2&date=20130401&atitle=Racial microaggressions and daily well-being among Asian Americans&aulast=Ong, A.D.&spage=188&sid=EBSCO:Scopus\u00ae&pid=Ong, A.D.edselc.2-52.0-8488267310420130401Scopus\u00ae",Article | Racial microaggressions and daily well-being among Asian Americans | Ong A D 2013 Apr 01 | Published in Journal Journal of Counseling Psychology Volume 60 Issue 2 Page 188. | ISSN:0022-0167,1,0,0,1,1,2,50,50,0,0,0,0,0
"getit.library.nyu.edu/resolve?genre=article&isbn=&issn=00221422&title=JOURNAL OF GERONTOLOGY&volume=32&issue=1&date=19770101&atitle=Stratum Contrasts and Similarities In Attitudes Toward Death.&aulast=Cuellar, J. B.&spage=76&sid=EBSCO:Chicano Database&pid=Cuellar, J. B.XCHD4499719770101Chicano Database",Article | Stratum Contrasts and Similarities In Attitudes Toward Death. | Cuellar J B 1977 Jan 01 | Published in Journal JOURNAL OF GERONTOLOGY Volume 32 Issue 1 Page 76. | ISSN:0022-1422,1,0,0,1,1,2,50,50,0,0,0,0,0
"getit.library.nyu.edu/resolve?genre=article&isbn=&issn=00222445&title=Journal of Marriage & Family=&volume=83&issue=5&date=20211001&atitle=Effects of Covid\u201019 lockdown on parental functioning in vulnerable families.&aulast=Helland, Maren Sand&spage=1515&sid=EBSCO:Education Source&pid=Helland, Maren Sand15284284820211001Education Source",Article | Effects of Covid\u201019 lockdown on parental functioning in vulnerable families. | Helland Maren Sand 2021 Oct 01 | Published in Journal Journal of Marriage Volume 83 Issue 5 Page 1515. | ISSN:0022-2445,4,3,0,7,4,11,64,36,0,0,0,0,0
getit.library.nyu.edu/resolve?genre=article&isbn=&issn=0022278X&title=The Journal of Modern African Studies&volume=49&issue=1&date=20110301&atitle=African Shenzhen: China's special economic zones in Africa&aulast=Deborah Br\u00e4utigam&spage=27&sid=EBSCO:JSTOR Journals&pid=Deborah Br\u00e4utigamedsjsr.2301887720110301JSTOR Journals,Article | African Shenzhen China's special economic zones in Africa | Deborah Br\u00e4utigam 2011 Mar 01 | Published in Journal The Journal of Modern African Studies Volume 49 Issue 1 Page 27. | ISSN:0022-278X,0,0,3,0,3,3,0,100,0,0,0,0,0
"getit.library.nyu.edu/resolve?genre=article&isbn=&issn=00222801&title=JOURNAL OF MODERN HISTORY&volume=92&issue=1&date=20200301&atitle=The Death of Democracy: Hitler's Rise to Power and the Downfall of the Weimar Republic.&aulast=Kurlander, Eric&spage=219&sid=EBSCO:Arts & Humanities Citation Index=&pid=Kurlander, Eric00051430150005920200301Arts & Humanities Citation Index=",Article | The Death of Democracy Hitler's Rise to Power and the Downfall of the Weimar Republic. | Kurlander Eric 2020 Mar 01 | Published in Journal JOURNAL OF MODERN HISTORY Volume 92 Issue 1 Page 219. | ISSN:0022-2801,2,0,0,2,2,4,50,50,0,0,0,0,0
"getit.library.nyu.edu/resolve?genre=article&isbn=&issn=00223263&title=Journal of Organic Chemistry&volume=74&issue=22&date=20091120&atitle=Efficient synthesis of 2-(trimethylsilyl)phenyl trifluoromethanesulfonate: A versatile precursor to o-benzyne&aulast=Bronner, S.M.&spage=8842&sid=EBSCO:Scopus\u00ae&pid=Bronner, S.M.edselc.2-52.0-7044963267220091120Scopus\u00ae",Article | Efficient synthesis of 2 trimethylsilyl)phenyl trifluoromethanesulfonate A versatile precursor to o-benzyne | Bronner S M 2009 Nov 20 | Published in Journal Journal of Organic Chemistry Volume 74 Issue 22 Page 8842. | ISSN:0022-3263,1,0,0,1,1,2,50,50,0,0,0,0,0
getit.library.nyu.edu/resolve?genre=article&isbn=&issn=00223433&title=Journal of Peace Research&volume=48&issue=4&date=20110701&atitle=Field research in conflict environments: Methodological challenges and snowball sampling&aulast=Nissim Cohen&spage=423&sid=EBSCO:JSTOR Journals&pid=Nissim Cohenedsjsr.2303520520110701JSTOR Journals,Article | Field research in conflict environments Methodological challenges and snowball sampling | Nissim Cohen 2011 Jul 01 | Published in Journal Journal of Peace Research Volume 48 Issue 4 Page 423. | ISSN:0022-3433,2,0,0,2,2,4,50,50,0,0,0,0,0
"getit.library.nyu.edu/resolve?genre=article&isbn=&issn=00223514&title=Journal of Personality and Social Psychology&volume=62&issue=6&date=19920101&atitle=A Theory of Generativity and Its Assessment Through Self-Report, Behavioral Acts, and Narrative Themes in Autobiography&aulast=McAdams, D.P.&spage=1003&sid=EBSCO:Scopus\u00ae&pid=McAdams, D.P.edselc.2-52.0-2714447059519920101Scopus\u00ae",Article | A Theory of Generativity and Its Assessment Through Self-Report Behavioral Acts and Narrative Themes in Autobiography | McAdams D P 1992 Jan 01 | Published in Journal Journal of Personality and Social Psychology Volume 62 Issue 6 Page 1003. | ISSN:0022-3514,1,0,0,1,1,2,50,50,0,0,0,0,0
"getit.library.nyu.edu/resolve?genre=article&isbn=&issn=00223840&title=Journal of Popular Culture&volume=49&issue=1&date=20160201&atitle=Fantasies of Exposure: Belly Dancing, the Veil, and the Drag of History.&aulast=MANSBRIDGE, JOANNA&spage=29&sid=EBSCO:Complementary Index&pid=MANSBRIDGE, JOANNA11320710820160201Complementary Index",Article | Fantasies of Exposure Belly Dancing the Veil and the Drag of History. | Mansbridge Joanna 2016 Feb 01 | Published in Journal Journal of Popular Culture Volume 49 Issue 1 Page 29. | ISSN:0022-3840,1,0,0,1,1,2,50,50,0,0,0,0,0
"getit.library.nyu.edu/resolve?genre=article&isbn=&issn=00223956&title=Journal of Psychiatric Research&volume=136&issue=&date=20210401&atitle=Intravenous ketamine for postmenopausal women with treatment-resistant depression: Results from the Canadian Rapid Treatment Center of Excellence&aulast=Lipsitz, Orly&spage=444&sid=EBSCO:ScienceDirect&pid=Lipsitz, OrlyS002239562030913420210401ScienceDirect",Article | Intravenous ketamine for postmenopausal women with treatment-resistant depression Results from the Canadian Rapid Treatment Center of Excellence | Lipsitz Orly 2021 Apr 01 | Published in Journal Journal of Psychiatric Research Volume 136 Page 444. | ISSN:0022-3956,0,0,1,0,1,1,0,100,0,0,0,0,0
"getit.library.nyu.edu/resolve?genre=article&isbn=&issn=00223999&title=Journal of Psychosomatic Research&volume=57&issue=5&date=20040101&atitle=The associations between childhood dance participation and adult disordered eating and related psychopathology&aulast=Ackard, Diann M.&spage=485&sid=EBSCO:ScienceDirect&pid=Ackard, Diann M.S002239990400446520040101ScienceDirect",Article | The associations between childhood dance participation and adult disordered eating and related psychopathology | Ackard Diann M 2004 Jan 01 | Published in Journal Journal of Psychosomatic Research Volume 57 Issue 5 Page 485. | ISSN:0022-3999,1,0,0,1,1,2,50,50,0,0,0,0,0
"getit.library.nyu.edu/resolve?genre=article&isbn=&issn=00224391&title=JOURNAL OF SCHOOL HEALTH&volume=69&issue=5&date=19990101&atitle=Informed Consent in School Health Research: Why, How, and Making It Easy&aulast=Ross, J. G.&spage=171&sid=EBSCO:British Library Document Supply Centre Inside Serials & Conference Proceedings=&pid=Ross, J. G.RN06212997919990101British Library Document Supply Centre Inside Serials & Conference Proceedings=",Article | Informed Consent in School Health Research Why How and Making It Easy | Ross J G 1999 Jan 01 | Published in Journal JOURNAL OF SCHOOL HEALTH Volume 69 Issue 5 Page 171. | ISSN:0022-4391,7,0,0,7,7,14,50,50,0,0,0,0,0
"getit.library.nyu.edu/resolve?genre=article&isbn=&issn=00225193&title=Journal of Theoretical Biology&volume=335&issue=&date=20131021&atitle=Dynamics and control at feedback vertex sets. II: A faithful monitor to determine the diversity of molecular activities in regulatory networks&aulast=Mochizuki, Atsushi&spage=130&sid=EBSCO:ScienceDirect&pid=Mochizuki, AtsushiS002251931300281620131021ScienceDirect",Article | Dynamics and control at feedback vertex sets II A faithful monitor to determine the diversity of molecular activities in regulatory networks | Mochizuki Atsushi 2013 Oct 21 | Published in Journal Journal of Theoretical Biology Volume 335 Page 130. | ISSN:0022-5193,1,0,0,1,1,2,50,50,0,0,0,0,0
"getit.library.nyu.edu/resolve?genre=article&isbn=&issn=00231940&title=Kiva&volume=82&issue=4&date=20161201&atitle=Ritual and Duality: Early Agricultural Period Figurines from the Tucson Basin.&aulast=Chenault, Mark L.&spage=387&sid=EBSCO:Complementary Index&pid=Chenault, Mark L.12026344920161201Complementary Index",Article | Ritual and Duality Early Agricultural Period Figurines from the Tucson Basin. | Chenault Mark L 2016 Dec 01 | Published in Journal Kiva Volume 82 Issue 4 Page 387. | ISSN:0023-1940,1,0,0,1,1,2,50,50,0,0,0,0,0
"getit.library.nyu.edu/resolve?genre=article&isbn=&issn=00260452&title=Meta&volume=61&issue=1&date=20160101&atitle=Doubt and negotiation: The perception of professional translators&aulast=Collombat, I.&spage=145&sid=EBSCO:Scopus\u00ae&pid=Collombat, I.edselc.2-52.0-8499022844320160101Scopus\u00ae",Article | Doubt and negotiation The perception of professional translators | Collombat I 2016 Jan 01 | Published in Journal Meta Volume 61 Issue 1 Page 145. | ISSN:0026-0452,0,0,1,0,1,1,0,100,0,0,0,0,0
"getit.library.nyu.edu/resolve?genre=article&isbn=&issn=00267902&title=Modern Language Journal&volume=105&issue=3&date=20210901&atitle=Communicative Effectiveness in BELF (English as a Business Lingua Franca) Meetings: 'Explaining' as a Pragmatic Strategy.&aulast=KAUR, JAGDISH&spage=623&sid=EBSCO:Education Full Text (H.W. Wilson)&pid=KAUR, JAGDISH15216624820210901Education Full Text (H.W. Wilson)",Article | Communicative Effectiveness in BELF English as a Business Lingua Franca Meetings Explaining as a Pragmatic Strategy. | Kaur Jagdish 2021 Sep 01 | Published in Journal Modern Language Journal Volume 105 Issue 3 Page 623. | ISSN:0026-7902,1,0,0,1,1,2,50,50,0,0,0,0,0
getit.library.nyu.edu/resolve?genre=article&isbn=&issn=00270520&title=MONTHLY REVIEW&volume=24&issue=11&date=19730401&atitle=CARS AND CITIES&aulast=SWEEZY P&spage=1&sid=EBSCO:Alternative Press Index Archive&pid=SWEEZY PALTPRCI-0502-00069319730401Alternative Press Index Archive,Article | CARS AND CITIES | SWEEZY P 1973 Apr 01 | Published in Journal MONTHLY REVIEW Volume 24 Issue 11 Page 1. | ISSN:0027-0520,1,0,0,1,1,2,50,50,0,0,0,0,0
"getit.library.nyu.edu/resolve?genre=article&isbn=&issn=00278424&title=Proceedings of the National Academy of Sciences of the United States of America&volume=115&issue=50&date=20181211&atitle=Genetically encodable bioluminescent system from fungi.&aulast=Kotlobay, Alexey A.&spage=12728&sid=EBSCO:Biological & Agricultural Index Plus (H.W. Wilson)=&pid=Kotlobay, Alexey A.13355385220181211Biological & Agricultural Index Plus (H.W. Wilson)=",Article | Genetically encodable bioluminescent system from fungi. | Kotlobay Alexey A 2018 Dec 11 | Published in Journal Proceedings of the National Academy of Sciences of the United States of America Volume 115 Issue 50 Page 12728. | ISSN:0027-8424,3,0,0,3,3,6,50,50,0,0,0,0,0
"getit.library.nyu.edu/resolve?genre=article&isbn=&issn=00283878&title=Neurology&volume=87&issue=2&date=20160712&atitle=Small fiber neuropathy is a common feature of Ehlers-Danlos syndromes.&aulast=Cazzato, Daniele&spage=155&sid=EBSCO:Complementary Index&pid=Cazzato, Daniele11679639420160712Complementary Index",Article | Small fiber neuropathy is a common feature of Ehlers-Danlos syndromes. | Cazzato Daniele 2016 Jul 12 | Published in Journal Neurology Volume 87 Issue 2 Page 155. | ISSN:0028-3878,3,0,0,3,3,6,50,50,0,0,0,0,0
"getit.library.nyu.edu/resolve?genre=article&isbn=&issn=00284793&title=New England Journal of Medicine&volume=385&issue=5&date=20210729&atitle=Depression in Adolescents.&aulast=Miller, Leslie&spage=445&sid=EBSCO:General Science Full Text (H.W. Wilson)&pid=Miller, Leslie15175160420210729General Science Full Text (H.W. Wilson)",Article | Depression in Adolescents. | Miller Leslie 2021 Jul 29 | Published in Journal New England Journal of Medicine Volume 385 Issue 5 Page 445. | ISSN:0028-4793,4,0,0,4,4,8,50,50,0,0,0,0,0
"getit.library.nyu.edu/resolve?genre=article&isbn=&issn=00287504&title=New York Review of Books&volume=28&issue=&date=19811119&atitle=Sweetheart of the silent majority: the biography of Phyllis Schlafly (Book Review)&aulast=FitzGerald, F.&spage=19&sid=EBSCO:Readers' Guide Retrospective: 1890-1982 (H.W. Wilson)&pid=FitzGerald, F.52445853019811119Readers' Guide Retrospective: 1890-1982 (H.W. Wilson)",Article | Sweetheart of the silent majority the biography of Phyllis Schlafly Book Review) | Fitzgerald F 1981 Nov 19 | Published in Journal New York Review of Books Volume 28 Page 19. | ISSN:0028-7504,2,0,0,2,2,4,50,50,0,0,0,0,0
"getit.library.nyu.edu/resolve?genre=article&isbn=&issn=0028792X&title=NEW YORKER -NEW YORKER MAGAZINE INCORPORATED-&volume=&issue=&date=19970101&atitle=Who Owns Anne Frank? Anne Frank has been distorted by everyone from her father to Broadway&aulast=Ozick, C.&spage=76&sid=EBSCO:British Library Document Supply Centre Inside Serials & Conference Proceedings=&pid=Ozick, C.RN03266596219970101British Library Document Supply Centre Inside Serials & Conference Proceedings=",Article | Who Owns Anne Frank Anne Frank has been distorted by everyone from her father to Broadway | Ozick C 1997 Jan 01 | Published in Journal NEW YORKER NEW YORKER MAGAZINE INCORPORATED Page 76. | ISSN:0028-792X,4,0,0,4,4,8,50,50,0,0,0,0,0
"getit.library.nyu.edu/resolve?genre=article&isbn=&issn=0028792X&title=NEW YORKER -NEW YORKER MAGAZINE INCORPORATED-&volume=&issue=&date=20040101&atitle=ANNALS OF CULTURE Something Borrowed Is it fair to complain about plagiarism?&aulast=Gladwell, M.&spage=40&sid=EBSCO:British Library Document Supply Centre Inside Serials & Conference Proceedings=&pid=Gladwell, M.RN15963304320040101British Library Document Supply Centre Inside Serials & Conference Proceedings=",Article | ANNALS OF CULTURE Something Borrowed Is it fair to complain about plagiarism? | Gladwell M 2004 Jan 01 | Published in Journal NEW YORKER NEW YORKER MAGAZINE INCORPORATED Page 40. | ISSN:0028-792X,11,0,0,11,11,22,50,50,0,0,0,0,0
"getit.library.nyu.edu/resolve?genre=article&isbn=&issn=0028792X&title=New Yorker&volume=36&issue=36&date=20041122&atitle=Something Borrowed: Should a Charge of Plagiarism Ruin Your Life?&aulast=Gladwell, Malcolm&spage=40&sid=EBSCO:MLA International Bibliography&pid=Gladwell, Malcolm200453352620041122MLA International Bibliography",Article | Something Borrowed Should a Charge of Plagiarism Ruin Your Life? | Gladwell Malcolm 2004 Nov 22 | Published in Journal New Yorker Volume 36 Issue 36 Page 40. | ISSN:0028-792X,0,0,12,0,12,12,0,100,0,0,0,0,0
"getit.library.nyu.edu/resolve?genre=article&isbn=&issn=0028792X&title=New Yorker&volume=72&issue=&date=19961007&atitle=On the edge.&aulast=Tomkins, Calvin&spage=100&sid=EBSCO:Readers' Guide Full Text Mega (H.W. Wilson)&pid=Tomkins, Calvin50348518119961007Readers' Guide Full Text Mega (H.W. Wilson)",Article | On the edge. | Tomkins Calvin 1996 Oct 07 | Published in Journal New Yorker Volume 72 Page 100. | ISSN:0028-792X,4,0,0,4,4,8,50,50,0,0,0,0,0
"getit.library.nyu.edu/resolve?genre=article&isbn=&issn=0028792X&title=New Yorker&volume=79&issue=27&date=20030922&atitle=The Stone Gardener.&aulast=Schama, Simon&spage=126&sid=EBSCO:Readers' Guide Full Text Mega (H.W. Wilson)&pid=Schama, Simon50387027320030922Readers' Guide Full Text Mega (H.W. Wilson)",Article | The Stone Gardener. | Schama Simon 2003 Sep 22 | Published in Journal New Yorker Volume 79 Issue 27 Page 126. | ISSN:0028-792X,11,0,0,11,11,22,50,50,0,0,0,0,0
"getit.library.nyu.edu/resolve?genre=article&isbn=&issn=0028792X&title=New Yorker&volume=82&issue=25&date=20060821&atitle=YOU, ME AND DUPREE.&aulast=Denby, David&spage=18&sid=EBSCO:Academic Search Complete&pid=Denby, David2202239320060821Academic Search Complete",Article | YOU ME AND DUPREE. | Denby David 2006 Aug 21 | Published in Journal New Yorker Volume 82 Issue 25 Page 18. | ISSN:0028-792X,0,0,12,0,12,12,0,100,0,0,0,0,0
"getit.library.nyu.edu/resolve?genre=article&isbn=&issn=00297844&title=Obstetrics & Gynecology=&volume=135&issue=2&date=20200201&atitle=Telehealth Interventions to Improve Obstetric and Gynecologic Health Outcomes: A Systematic Review.&aulast=DeNicola, Nathaniel&spage=371&sid=EBSCO:CINAHL Complete&pid=DeNicola, Nathaniel14389701220200201CINAHL Complete",Article | Telehealth Interventions to Improve Obstetric and Gynecologic Health Outcomes A Systematic Review. | Denicola Nathaniel 2020 Feb 01 | Published in Journal Obstetrics Volume 135 Issue 2 Page 371. | ISSN:0029-7844,2,0,0,2,2,4,50,50,0,0,0,0,0
getit.library.nyu.edu/resolve?genre=article&isbn=&issn=00300071&title=Off Our Backs&volume=24&issue=3&date=19940301&atitle=Trouble in paradise.&aulast=Johnson A&spage=14&sid=EBSCO:Alternative Press Index&pid=Johnson AALTP261wk03619940301Alternative Press Index,Article | Trouble in paradise. | Johnson A 1994 Mar 01 | Published in Journal Off Our Backs Volume 24 Issue 3 Page 14. | ISSN:0030-0071,3,0,0,3,3,6,50,50,0,0,0,0,0
"getit.library.nyu.edu/resolve?genre=article&isbn=&issn=00302228&title=Omega&volume=21&issue=1&date=19900101&atitle=Death experience and religion&aulast=Peterson, Steven A&spage=75&sid=EBSCO:Atla Religion Database&pid=Peterson, Steven AATLA000084671819900101Atla Religion Database",Article | Death experience and religion | Peterson Steven A 1990 Jan 01 | Published in Journal Omega Volume 21 Issue 1 Page 75. | ISSN:0030-2228,1,0,0,1,1,2,50,50,0,0,0,0,0
"getit.library.nyu.edu/resolve?genre=article&isbn=&issn=00308129&title=PMLA: Publications of the Modern Language Association of America&volume=130&issue=5&date=20151001&atitle=Animals Are from Venus, Human Beings from Mars: Averro\u00ebs's Aristotle and the Rationality of Emotion in Guido Cavalcanti's 'Donna me prega'&aulast=Stone, Gregory B.&spage=1269&sid=EBSCO:MLA International Bibliography&pid=Stone, Gregory B.201638005220151001MLA International Bibliography",Article | Animals Are from Venus Human Beings from Mars Averro\u00ebs's Aristotle and the Rationality of Emotion in Guido Cavalcanti's Donna me prega' | Stone Gregory B 2015 Oct 01 | Published in Journal PMLA Publications of the Modern Language Association of America Volume 130 Issue 5 Page 1269. | ISSN:0030-8129,4,0,0,4,4,8,50,50,0,0,0,0,0
"getit.library.nyu.edu/resolve?genre=article&isbn=&issn=00311294&title=Papers on Language and Literature: A Journal for Scholars and Critics of Language and Literature&volume=4&issue=4&date=20020101&atitle=The Separation of Wild Animal Nature and Human Nature in Gilgamesh: Roots of a Contemporary Theme&aulast=Barron, Patrick&spage=377&sid=EBSCO:MLA International Bibliography&pid=Barron, Patrick200258204720020101MLA International Bibliography",Article | The Separation of Wild Animal Nature and Human Nature in Gilgamesh Roots of a Contemporary Theme | Barron Patrick 2002 Jan 01 | Published in Journal Papers on Language and Literature A Journal for Scholars and Critics of Language and Literature Volume 4 Issue 4 Page 377. | ISSN:0031-1294,6,1,0,7,6,13,54,46,0,0,0,0,0
"getit.library.nyu.edu/resolve?genre=article&isbn=&issn=00323217&title=Political Studies&volume=7&issue=1&date=19590201&atitle=THE CONSTITUTION OF THE FIFTH REPUBLIC; A COMMENTARY1.&aulast=HARRISON, MARTIN&spage=41&sid=EBSCO:Complementary Index&pid=HARRISON, MARTIN6277978419590201Complementary Index",Article | THE CONSTITUTION OF THE FIFTH REPUBLIC | Harrison Martin 1959 Feb 01 | Published in Journal Political Studies Volume 7 Issue 1 Page 41. | ISSN:0032-3217,0,3,3,3,3,6,50,50,0,0,0,0,0
"getit.library.nyu.edu/resolve?genre=article&isbn=&issn=00332836&title=Psychoanalytic Review&volume=105&issue=2&date=20180401&atitle=Get Out: A Study of Interracial Dynamics in an Unrepaired and Unrepentant America-A Modern Day Racial Horror.&aulast=Nichols, Bryan K.&spage=223&sid=EBSCO:Complementary Index&pid=Nichols, Bryan K.12885674920180401Complementary Index",Article | Get Out A Study of Interracial Dynamics in an Unrepaired and Unrepentant America-A Modern Day Racial Horror. | Nichols Bryan K 2018 Apr 01 | Published in Journal Psychoanalytic Review Volume 105 Issue 2 Page 223. | ISSN:0033-2836,2,0,0,2,2,4,50,50,0,0,0,0,0
"getit.library.nyu.edu/resolve?genre=article&isbn=&issn=00333549&title=Public Health Reports&volume=136&issue=1&date=20210101&atitle=Mental Health Providers During COVID-19: Essential to the US Public Health Workforce and in Need of Support.&aulast=Fish, Jessica N.&spage=14&sid=EBSCO:General Science Full Text (H.W. Wilson)&pid=Fish, Jessica N.14738068620210101General Science Full Text (H.W. Wilson)",Article | Mental Health Providers During COVID-19 Essential to the US Public Health Workforce and in Need of Support. | Fish Jessica N 2021 Jan 01 | Published in Journal Public Health Reports Volume 136 Issue 1 Page 14. | ISSN:0033-3549,3,0,0,3,3,6,50,50,0,0,0,0,0
"getit.library.nyu.edu/resolve?genre=article&isbn=&issn=00353337&title=Revue internationale de droit compar\u00e9&volume=23&issue=3&date=19710101&atitle=Etudes de logique juridique, vol. IV, Le raisonnement juridique et la logique d\u00e9ontique (Actes du Colloque de Bruxelles, 22-23 d\u00e9cembre 1969), publi\u00e9 par Ch. Perelman&aulast=&spage=679&sid=EBSCO:Pers\u00e9e&pid=edsper.ridc.0035.3337.1971.num.23.3.1606919710101Pers\u00e9e",Article | Etudes de logique juridique vol IV Le raisonnement juridique et la logique d\u00e9ontique Actes du Colloque de Bruxelles 22-23 d\u00e9cembre 1969 publi\u00e9 par Ch Perelman | 1971 Jan 01 | Published in Journal Revue internationale de droit compar\u00e9 Volume 23 Issue 3 Page 679. | ISSN:0035-3337,2,0,0,2,2,4,50,50,0,0,0,0,0
getit.library.nyu.edu/resolve?genre=article&isbn=&issn=00368075&title=Science&volume=289&issue=5479&date=20000728&atitle=Primates: A Natural Heritage of Conflict Resolution&aulast=Frans B. M. de Waal&spage=586&sid=EBSCO:JSTOR Journals&pid=Frans B. M. de Waaledsjsr.307752620000728JSTOR Journals,Article | Primates A Natural Heritage of Conflict Resolution | Frans B M de Waal 2000 Jul 28 | Published in Journal Science Volume 289 Issue 5479 Page 586. | ISSN:0036-8075,10,0,0,10,10,20,50,50,0,0,0,0,0
"getit.library.nyu.edu/resolve?genre=article&isbn=&issn=00368075&title=Science&volume=6497&issue=&date=20200101&atitle=Understanding persistent gender gaps in STEM&aulast=Cimpian, Joseph R.&spage=1317&sid=EBSCO:British Library Document Supply Centre Inside Serials & Conference Proceedings=&pid=Cimpian, Joseph R.RN62392023020200101British Library Document Supply Centre Inside Serials & Conference Proceedings=",Article | Understanding persistent gender gaps in STEM | Cimpian Joseph R 2020 Jan 01 | Published in Journal Science Volume 6497 Page 1317. | ISSN:0036-8075,2,0,0,2,2,4,50,50,0,0,0,0,0
"getit.library.nyu.edu/resolve?genre=article&isbn=&issn=00368237&title=Science & Society=&volume=85&issue=1&date=20210101&atitle=Gendercraft: Marxism-feminism, reproduction, and the blind spot of money.&aulast=Lange, Elena&spage=38&sid=EBSCO:Alternative Press Index&pid=Lange, ElenaALTP99945420210101Alternative Press Index",Article | Gendercraft Marxism-feminism reproduction and the blind spot of money. | Lange Elena 2021 Jan 01 | Published in Journal Science Volume 85 Issue 1 Page 38. | ISSN:0036-8237,1,0,0,1,1,2,50,50,0,0,0,0,0
"getit.library.nyu.edu/resolve?genre=article&isbn=&issn=00368733&title=Scientific American&volume=300&issue=1&date=20090101&atitle=Testing Natural Selection.&aulast=Orr, H. Allen&spage=44&sid=EBSCO:Academic Search Complete&pid=Orr, H. Allen3605675220090101Academic Search Complete",Article | Testing Natural Selection. | Orr H Allen 2009 Jan 01 | Published in Journal Scientific American Volume 300 Issue 1 Page 44. | ISSN:0036-8733,3,0,0,3,3,6,50,50,0,0,0,0,0
"getit.library.nyu.edu/resolve?genre=article&isbn=&issn=00377317&title=SMITH COLLEGE STUDIES IN SOCIAL WORK&volume=81&issue=2/3&date=20110101&atitle=Why We Need a Biopsychosocial Perspective with Vulnerable, Oppressed, and At-Risk Clients&aulast=Berzoff, J.&spage=132&sid=EBSCO:British Library Document Supply Centre Inside Serials & Conference Proceedings=&pid=Berzoff, J.RN29801225820110101British Library Document Supply Centre Inside Serials & Conference Proceedings=",Article | Why We Need a Biopsychosocial Perspective with Vulnerable Oppressed and At-Risk Clients | Berzoff J 2011 Jan 01 | Published in Journal SMITH COLLEGE STUDIES IN SOCIAL WORK Volume 81 Issue 2/3 Page 132. | ISSN:0037-7317,1,0,0,1,1,2,50,50,0,0,0,0,0
"getit.library.nyu.edu/resolve?genre=article&isbn=&issn=00393495&title=Studies: An Irish Quarterly&volume=105&issue=417&date=20160301&atitle=Revolutionary Commemoration and the Mythologisation of History.&aulast=Kleinman, Sylvie&spage=31&sid=EBSCO:Humanities Source&pid=Kleinman, Sylvie11381600020160301Humanities Source",Article | Revolutionary Commemoration and the Mythologisation of History. | Kleinman Sylvie 2016 Mar 01 | Published in Journal Studies An Irish Quarterly Volume 105 Issue 417 Page 31. | ISSN:0039-3495,2,0,0,2,2,4,50,50,0,0,0,0,0
"getit.library.nyu.edu/resolve?genre=article&isbn=&issn=00404187&title=Texas Bar Journal&volume=84&issue=2&date=20210201&atitle=In Their Own Words: A Black History Month Roundtable Discussion with African American Deans of Texas Law Schools&aulast=LeBlanc, Miles J.&spage=142&sid=EBSCO:HeinOnline&pid=LeBlanc, Miles J.edshol.hein.barjournals.texbarj0084.6920210201HeinOnline",Article | In Their Own Words A Black History Month Roundtable Discussion with African American Deans of Texas Law Schools | Leblanc Miles J 2021 Feb 01 | Published in Journal Texas Bar Journal Volume 84 Issue 2 Page 142. | ISSN:0040-4187,4,0,0,4,4,8,50,50,0,0,0,0,0
"getit.library.nyu.edu/resolve?genre=article&isbn=&issn=00420980&title=Urban Studies (Sage Publications, Ltd.)&volume=57&issue=13&date=20201001&atitle=Social policies, financial markets and the multi-scalar governance of affordable housing in Toronto.&aulast=Zhang, Beibei&spage=2628&sid=EBSCO:SocINDEX with Full Text&pid=Zhang, Beibei14575120720201001SocINDEX with Full Text",Article | Social policies financial markets and the multi-scalar governance of affordable housing in Toronto. | Zhang Beibei 2020 Oct 01 | Published in Journal Urban Studies Sage Publications Ltd Volume 57 Issue 13 Page 2628. | ISSN:0042-0980,0,0,1,0,1,1,0,100,0,0,0,0,0
"getit.library.nyu.edu/resolve?genre=article&isbn=&issn=00472328&title=Journal of Comparative Family Studies&volume=52&issue=1&date=20210101&atitle=Is it Possible for Single Parents to Successfully Raise Children? Multilevel Analysis of Attitudes Toward Single Parents in 22 Welfare States.&aulast=Hakovirta, Mia&spage=117&sid=EBSCO:Social Sciences Full Text (H.W. Wilson)&pid=Hakovirta, Mia14983610720210101Social Sciences Full Text (H.W. Wilson)",Article | Is it Possible for Single Parents to Successfully Raise Children Multilevel Analysis of Attitudes Toward Single Parents in 22 Welfare States. | Hakovirta Mia 2021 Jan 01 | Published in Journal Journal of Comparative Family Studies Volume 52 Issue 1 Page 117. | ISSN:0047-2328,4,2,0,6,4,10,60,40,0,0,0,0,0
getit.library.nyu.edu/resolve?genre=article&isbn=&issn=00475394&title=McKinsey Quarterly&volume=&issue=&date=&atitle=&aulast=&spage=&sid=EBSCO:Business Source Complete -- Publications&pid=Business Source Complete -- Publications,Article | McKinsey Quarterly |  | ISSN:0047-5394 | undefined,0,0,4,0,4,4,0,100,0,0,0,0,0
getit.library.nyu.edu/resolve?genre=article&isbn=&issn=00778958&title=Metropolitan Museum Journal&volume=27&issue=&date=19920101&atitle=Hans Memling's \,Article | Hans Memling's  | 1992 Jan 01 | Published in Journal Metropolitan Museum Journal Volume 27. | ISSN:0077-8958,0,0,2,0,2,2,0,100,0,0,0,0,0
"getit.library.nyu.edu/resolve?genre=article&isbn=&issn=00909882&title=Journal of Applied Communication Research&volume=48&issue=4&date=20200901&atitle=Reducing political polarization through narrative writing.&aulast=Warner, Benjamin R.&spage=459&sid=EBSCO:Communication & Mass Media Complete=&pid=Warner, Benjamin R.14567082720200901Communication & Mass Media Complete=",Article | Reducing political polarization through narrative writing. | Warner Benjamin R 2020 Sep 01 | Published in Journal Journal of Applied Communication Research Volume 48 Issue 4 Page 459. | ISSN:0090-9882,2,0,0,2,2,4,50,50,0,0,0,0,0
"getit.library.nyu.edu/resolve?genre=article&isbn=&issn=00914509&title=Contemporary Drug Problems&volume=43&issue=3&date=20160101&atitle=Toward the Smarter Use of Smart Drugs: Perceptions and Experiences of University Students in the Netherlands and Lithuania&aulast=Hupli, Aleksi&spage=242&sid=EBSCO:HeinOnline&pid=Hupli, Aleksiedshol.hein.journals.condp43.2420160101HeinOnline",Article | Toward the Smarter Use of Smart Drugs Perceptions and Experiences of University Students in the Netherlands and Lithuania | Hupli Aleksi 2016 Jan 01 | Published in Journal Contemporary Drug Problems Volume 43 Issue 3 Page 242. | ISSN:0091-4509,8,0,0,8,8,16,50,50,0,0,0,0,0
"getit.library.nyu.edu/resolve?genre=article&isbn=&issn=00918369&title=Journal of Homosexuality&volume=68&issue=5&date=20210401&atitle=The Role of Masculinity Threat in Homonegativity and Transphobia.&aulast=Konopka, Karolina&spage=802&sid=EBSCO:Social Sciences Full Text (H.W. Wilson)&pid=Konopka, Karolina14901304420210401Social Sciences Full Text (H.W. Wilson)",Article | The Role of Masculinity Threat in Homonegativity and Transphobia. | Konopka Karolina 2021 Apr 01 | Published in Journal Journal of Homosexuality Volume 68 Issue 5 Page 802. | ISSN:0091-8369,2,1,0,3,2,5,60,40,0,0,0,0,0
"getit.library.nyu.edu/resolve?genre=article&isbn=&issn=0094582X&title=Latin American Perspectives&volume=48&issue=6&date=20211101&atitle=Cuba: The July 11, 2021, Protests.&aulast=L\u00f3pez Segrera, Francisco&spage=37&sid=EBSCO:America: History and Life with Full Text&pid=L\u00f3pez Segrera, Francisco15252175220211101America: History and Life with Full Text",Article | Cuba The July 11 2021 Protests. | Lu00f3pez-Segrera Francisco 2021 Nov 01 | Published in Journal Latin American Perspectives Volume 48 Issue 6 Page 37. | ISSN:0094-582X,1,0,0,1,1,2,50,50,0,0,0,0,0
"getit.library.nyu.edu/resolve?genre=article&isbn=&issn=00953997&title=Administration & Society=&volume=52&issue=9&date=20201001&atitle=Does Participatory Budgeting Alter Public Spending? Evidence From New York City.&aulast=Calabrese, Thad&spage=1382&sid=EBSCO:Complementary Index&pid=Calabrese, Thad14503572220201001Complementary Index",Article | Does Participatory Budgeting Alter Public Spending Evidence From New York City. | Calabrese Thad 2020 Oct 01 | Published in Journal Administration Volume 52 Issue 9 Page 1382. | ISSN:0095-3997,2,0,0,2,2,4,50,50,0,0,0,0,0
"getit.library.nyu.edu/resolve?genre=article&isbn=&issn=00963445&title=Journal of Experimental Psychology: General&volume=150&issue=7&date=20210701&atitle=Levels of interpersonal trust across different types of environment: The micro\u2013macro interplay between relational distance and human ecology.&aulast=Jing, Yiming&spage=1438&sid=EBSCO:APA PsycArticles&pid=Jing, Yiming2020-87882-00120210701APA PsycArticles",Article | Levels of interpersonal trust across different types of environment The micro\u2013macro interplay between relational distance and human ecology. | Jing Yiming 2021 Jul 01 | Published in Journal Journal of Experimental Psychology General Volume 150 Issue 7 Page 1438. | ISSN:0096-3445,1,0,0,1,1,2,50,50,0,0,0,0,0
"getit.library.nyu.edu/resolve?genre=article&isbn=&issn=00989258&title=Advances in consumer research&volume=45&issue=&date=20170101&atitle=Luxurious Emirati Weddings: The Expenses, Pressures and Consequences&aulast=Arthur, Damien&spage=1001&sid=EBSCO:British Library Document Supply Centre Inside Serials & Conference Proceedings=&pid=Arthur, DamienCN60462082820170101British Library Document Supply Centre Inside Serials & Conference Proceedings=",Article | Luxurious Emirati Weddings The Expenses Pressures and Consequences | Arthur Damien 2017 Jan 01 | Published in Journal Advances in consumer research Volume 45 Page 1001. | ISSN:0098-9258,2,0,0,2,2,4,50,50,0,0,0,0,0
"getit.library.nyu.edu/resolve?genre=article&isbn=&issn=00989258&title=Advances in consumer research&volume=46&issue=&date=20180101&atitle=I4. Pink Tax: Are Some Marketing Practices Discriminatory?&aulast=Bennett, Andrea Rochelle&spage=900&sid=EBSCO:British Library Document Supply Centre Inside Serials & Conference Proceedings=&pid=Bennett, Andrea RochelleCN60550251720180101British Library Document Supply Centre Inside Serials & Conference Proceedings=",Article | I4 Pink Tax Are Some Marketing Practices Discriminatory? | Bennett Andrea Rochelle 2018 Jan 01 | Published in Journal Advances in consumer research Volume 46 Page 900. | ISSN:0098-9258,2,0,0,2,2,4,50,50,0,0,0,0,0
"getit.library.nyu.edu/resolve?genre=article&isbn=&issn=01032070&title=Tempo Social: Revista de Sociologia da USP&volume=18&issue=1&date=20060501&atitle=Rebeli\u00d5es urbanas e a desestrutura\u00e7\u00e3o das classes populares (Fran\u00e7a, 2005).&aulast=Beaud, St\u00e9phane&spage=37&sid=EBSCO:SocINDEX with Full Text&pid=Beaud, St\u00e9phane2265602020060501SocINDEX with Full Text",Article | Rebeli\u00d5es urbanas e a desestrutura\u00e7\u00e3o das classes populares Fran\u00e7a 2005  | Beaud Stu00e9phane 2006 May 01 | Published in Journal Tempo Social Revista de Sociologia da USP Volume 18 Issue 1 Page 37. | ISSN:0103-2070,3,1,1,4,4,8,50,50,0,0,0,0,0
"getit.library.nyu.edu/resolve?genre=article&isbn=&issn=01401971&title=Journal of Adolescence&volume=87&issue=&date=20210201&atitle=Identity synthesis and confusion in early to late adolescents: Age trends, gender differences, and associations with depressive symptoms.&aulast=Bogaerts, Annabel&spage=106&sid=EBSCO:Social Sciences Full Text (H.W. Wilson)&pid=Bogaerts, Annabel14873116120210201Social Sciences Full Text (H.W. Wilson)",Article | Identity synthesis and confusion in early to late adolescents Age trends gender differences and associations with depressive symptoms. | Bogaerts Annabel 2021 Feb 01 | Published in Journal Journal of Adolescence Volume 87 Page 106. | ISSN:0140-1971,2,0,0,2,2,4,50,50,0,0,0,0,0
"getit.library.nyu.edu/resolve?genre=article&isbn=&issn=0140525X&title=Behavioral & Brain Sciences=&volume=20&issue=2&date=19970601&atitle=Could we take lime, purple, orange, and teal as unique hues?&aulast=Broackes, Justin&spage=183&sid=EBSCO:Academic Search Complete&pid=Broackes, Justin971214343119970601Academic Search Complete",Article | Could we take lime purple orange and teal as unique hues? | Broackes Justin 1997 Jun 01 | Published in Journal Behavioral Volume 20 Issue 2 Page 183. | ISSN:0140-525X,1,0,0,1,1,2,50,50,0,0,0,0,0
"getit.library.nyu.edu/resolve?genre=article&isbn=&issn=01459740&title=Medical anthropology&volume=40&issue=2&date=20210101&atitle=The Ecology of Disabled Minds in Urban Uganda&aulast=Zoanni, Tyler&spage=169&sid=EBSCO:British Library Document Supply Centre Inside Serials & Conference Proceedings=&pid=Zoanni, Tylervdc.100116496776.0x00000120210101British Library Document Supply Centre Inside Serials & Conference Proceedings=",Article | The Ecology of Disabled Minds in Urban Uganda | Zoanni Tyler 2021 Jan 01 | Published in Journal Medical anthropology Volume 40 Issue 2 Page 169. | ISSN:0145-9740,1,0,0,1,1,2,50,50,0,0,0,0,0
"getit.library.nyu.edu/resolve?genre=article&isbn=&issn=01461672&title=Personality & Social Psychology Bulletin=&volume=42&issue=12&date=20161201&atitle=The \u201cBad Is Black\u201d Effect.&aulast=Alter, Adam L.&spage=1653&sid=EBSCO:Education Full Text (H.W. Wilson)&pid=Alter, Adam L.11954633520161201Education Full Text (H.W. Wilson)",Article | The u201cBad Is Black\u201d Effect. | Alter Adam L 2016 Dec 01 | Published in Journal Personality Volume 42 Issue 12 Page 1653. | ISSN:0146-1672,1,0,0,1,1,2,50,50,0,0,0,0,0
"getit.library.nyu.edu/resolve?genre=article&isbn=&issn=01463934&title=College Student Journal&volume=42&issue=3&date=20080901&atitle=FACTORIAL STRUCTURE OF BRIEF COPE FOR INTERNATIONAL STUDENTS ATTENDING U.S. COLLEGES.&aulast=Miyazaki, Yasuo&spage=795&sid=EBSCO:Academic Search Complete&pid=Miyazaki, Yasuo3426266820080901Academic Search Complete",Article | FACTORIAL STRUCTURE OF BRIEF COPE FOR INTERNATIONAL STUDENTS ATTENDING U.S COLLEGES. | Miyazaki Yasuo 2008 Sep 01 | Published in Journal College Student Journal Volume 42 Issue 3 Page 795. | ISSN:0146-3934,4,2,0,6,4,10,60,40,0,0,0,0,0
getit.library.nyu.edu/resolve?genre=article&isbn=&issn=01495380&title=WWD: Women's Wear Daily&volume=&issue=&date=20211007&atitle=Buyers Hail Strong Paris Collections: The Simpson family's turn on the Balenciaga runway won buyers' hearts in what proved to be a powerful Paris Fashion Week.&aulast=&spage=1&sid=EBSCO:Business Source Complete&pid=15288079420211007Business Source Complete,Article | Buyers Hail Strong Paris Collections The Simpson family's turn on the Balenciaga runway won buyers hearts in what proved to be a powerful Paris Fashion Week. | 2021 Oct 07 | Published in Journal WWD Women's Wear Daily Page 1. | ISSN:0149-5380,6,1,0,7,6,13,54,46,0,0,0,0,0
getit.library.nyu.edu/resolve?genre=article&isbn=&issn=01533320&title=Cahiers de linguistique - Asie orientale&volume=35&issue=2&date=20060101&atitle=Two general classifiers in the Shangai Wu dialect : a comparison with Mandarin and Cantonese&aulast=Mary S. Erbaugh&spage=169&sid=EBSCO:Pers\u00e9e&pid=Mary S. Erbaughedsper.clao.0153.3320.2006.num.35.2.175620060101Pers\u00e9e,Article | Two general classifiers in the Shangai Wu dialect a comparison with Mandarin and Cantonese | Mary S Erbaugh 2006 Jan 01 | Published in Journal Cahiers de linguistique Asie orientale Volume 35 Issue 2 Page 169. | ISSN:0153-3320,4,0,0,4,4,8,50,50,0,0,0,0,0
"getit.library.nyu.edu/resolve?genre=article&isbn=&issn=01622870&title=October&volume=&issue=91&date=20000101&atitle=Performance, video, and the rhetoric of presence.&aulast=Wagner, Anne M.&spage=59&sid=EBSCO:Art & Architecture Source=&pid=Wagner, Anne M.50489749720000101Art & Architecture Source=",Article | Performance video and the rhetoric of presence. | Wagner Anne M 2000 Jan 01 | Published in Journal October Issue 91 Page 59. | ISSN:0162-2870,0,0,2,0,2,2,0,100,0,0,0,0,0
"getit.library.nyu.edu/resolve?genre=article&isbn=&issn=01650327&title=Journal of Affective Disorders&volume=296&issue=&date=20220101&atitle=Perceived academic stress and depressive symptoms among Chinese adolescents: A moderated mediation analysis of overweight status&aulast=Fu, Yan&spage=224&sid=EBSCO:ScienceDirect&pid=Fu, YanS016503272101019320220101ScienceDirect",Article | Perceived academic stress and depressive symptoms among Chinese adolescents A moderated mediation analysis of overweight status | Fu Yan 2022 Jan 01 | Published in Journal Journal of Affective Disorders Volume 296 Page 224. | ISSN:0165-0327,1,0,0,1,1,2,50,50,0,0,0,0,0
"getit.library.nyu.edu/resolve?genre=article&isbn=&issn=01876961&title=Estudios Fronterizos&volume=21&issue=&date=20200101&atitle=Ventanillas de Salud: Desaf\u00edos en el acceso a servicios de salud de inmigrantes mexicanos en ee. uu.&aulast=Marina Valle, Valeria&spage=1&sid=EBSCO:Academic Search Complete&pid=Marina Valle, Valeria14684139220200101Academic Search Complete",Article | Ventanillas de Salud Desaf\u00edos en el acceso a servicios de salud de inmigrantes mexicanos en ee uu. | Marina Valle Valeria 2020 Jan 01 | Published in Journal Estudios Fronterizos Volume 21 Page 1. | ISSN:0187-697X,3,1,1,4,4,8,50,50,0,0,0,0,0
"getit.library.nyu.edu/resolve?genre=article&isbn=&issn=01911961&title=MISSOURI REVIEW&volume=42&issue=1&date=20190301&atitle=I can't say I loved punk when punk was contagious, CBGB nearly every night&aulast=Seuss, Diane&spage=14&sid=EBSCO:Arts & Humanities Citation Index=&pid=Seuss, Diane00046855650000520190301Arts & Humanities Citation Index=",Article | I can't say I loved punk when punk was contagious CBGB nearly every night | Seuss Diane 2019 Mar 01 | Published in Journal MISSOURI REVIEW Volume 42 Issue 1 Page 14. | ISSN:0191-1961,1,0,0,1,1,2,50,50,0,0,0,0,0
"getit.library.nyu.edu/resolve?genre=article&isbn=&issn=0192513X&title=JOURNAL OF FAMILY ISSUES&volume=&issue=&date=20210702&atitle=Personality Traits and Attachments Styles in Romantic Relationships Deciding&aulast=Tosun, Cansu&spage=&sid=EBSCO:Social Sciences Citation Index&pid=Tosun, Cansu00067142030000120210702Social Sciences Citation Index",Article | Personality Traits and Attachments Styles in Romantic Relationships Deciding | Tosun Cansu 2021 Jul 02 | Published in Journal JOURNAL OF FAMILY ISSUES. | ISSN:0192-513X,0,0,1,0,1,1,0,100,0,0,0,0,0
getit.library.nyu.edu/resolve?genre=article&isbn=&issn=01937235&title=Journal of Sport & Social Issues=&volume=45&issue=4&date=20210801&atitle=\,Article | \ | 2021 Aug 01 | Published in Journal Journal of Sport Volume 45 Issue 4. | ISSN:0193-7235,1,0,0,1,1,2,50,50,0,0,0,0,0
"getit.library.nyu.edu/resolve?genre=article&isbn=&issn=01951920&title=Phalanx&volume=47&issue=4&date=20141201&atitle=Workforce Management Analysis : From Talent Acquisition, Through Force Shaping and Professional Growth, into Knowledge Transfer \u2013 A Focus on a Critical Skill&aulast=Matos Rafael E.&spage=4&sid=EBSCO:JSTOR Journals&pid=Matos Rafael E.edsjsr.2491064820141201JSTOR Journals",Article | Workforce Management Analysis From Talent Acquisition Through Force Shaping and Professional Growth into Knowledge Transfer u2013 A Focus on a Critical Skill | Matos Rafael E 2014 Dec 01 | Published in Journal Phalanx Volume 47 Issue 4 Page 4. | ISSN:0195-1920,1,0,0,1,1,2,50,50,0,0,0,0,0
"getit.library.nyu.edu/resolve?genre=article&isbn=&issn=01956663&title=APPETITE&volume=129&issue=&date=20181001&atitle=Misperceived norms and personal sugar-sweetened beverage consumption and fruit and vegetable intake among students in the United States&aulast=Perkins, Jessica M.&spage=82&sid=EBSCO:Science Citation Index Expanded&pid=Perkins, Jessica M.00044297440001020181001Science Citation Index Expanded",Article | Misperceived norms and personal sugar-sweetened beverage consumption and fruit and vegetable intake among students in the United States | Perkins Jessica M 2018 Oct 01 | Published in Journal APPETITE Volume 129 Page 82. | ISSN:0195-6663,1,0,0,1,1,2,50,50,0,0,0,0,0
"getit.library.nyu.edu/resolve?genre=article&isbn=&issn=01956663&title=Appetite&volume=79&issue=&date=20140801&atitle=Clues to maintaining calorie restriction? Psychosocial profiles of successful long-term restrictors&aulast=Incollingo Belsky, Angela C.&spage=106&sid=EBSCO:ScienceDirect&pid=Incollingo Belsky, Angela C.S019566631400171820140801ScienceDirect",Article | Clues to maintaining calorie restriction Psychosocial profiles of successful long-term restrictors | Incollingo Belsky Angela C 2014 Aug 01 | Published in Journal Appetite Volume 79 Page 106. | ISSN:0195-6663,1,0,0,1,1,2,50,50,0,0,0,0,0
"getit.library.nyu.edu/resolve?genre=article&isbn=&issn=02636352&title=JOURNAL OF HYPERTENSION&volume=37&issue=6&date=20190601&atitle=Influence of blood pressure on the effects of low-dose asprin in elderly patients with multiple atherosclerotic risks&aulast=Ando, Katsuyuki&spage=1301&sid=EBSCO:Science Citation Index&pid=Ando, Katsuyuki00048075990002520190601Science Citation Index",Article | Influence of blood pressure on the effects of low-dose asprin in elderly patients with multiple atherosclerotic risks | Ando Katsuyuki 2019 Jun 01 | Published in Journal JOURNAL OF HYPERTENSION Volume 37 Issue 6 Page 1301. | ISSN:0263-6352,2,0,0,2,2,4,50,50,0,0,0,0,0
"getit.library.nyu.edu/resolve?genre=article&isbn=&issn=02664909&title=Journal of Computer Assisted Learning&volume=28&issue=1&date=20120201&atitle=Quality in e-learning - a conceptual framework based on experiences from three international benchmarking projects.&aulast=Ossiannilsson, E.&spage=42&sid=EBSCO:CINAHL Complete&pid=Ossiannilsson, E.10462705920120201CINAHL Complete",Article | Quality in e-learning a conceptual framework based on experiences from three international benchmarking projects. | Ossiannilsson E 2012 Feb 01 | Published in Journal Journal of Computer Assisted Learning Volume 28 Issue 1 Page 42. | ISSN:0266-4909,1,0,0,1,1,2,50,50,0,0,0,0,0
"getit.library.nyu.edu/resolve?genre=article&isbn=&issn=02697491&title=Environmental Pollution&volume=185&issue=&date=20140201&atitle=Why small and medium chemical companies continue to pose severe environmental risks in rural China.&aulast=He, Guizhen&spage=158&sid=EBSCO:Biological & Agricultural Index Plus (H.W. Wilson)=&pid=He, Guizhen9327046020140201Biological & Agricultural Index Plus (H.W. Wilson)=",Article | Why small and medium chemical companies continue to pose severe environmental risks in rural China. | He Guizhen 2014 Feb 01 | Published in Journal Environmental Pollution Volume 185 Page 158. | ISSN:0269-7491,1,0,0,1,1,2,50,50,0,0,0,0,0
"getit.library.nyu.edu/resolve?genre=article&isbn=&issn=02753987&title=Psychomusicology: Music, Mind & Brain=&volume=31&issue=1&date=20210301&atitle=Do Singing and Talking Arise From the Same or Different Neurological Systems? Dissociations of Pitch, Timing, and Rhythm in Two Dysprosodic Singers.&aulast=Van Lancker Sidtis, Diana&spage=18&sid=EBSCO:Academic Search Complete&pid=Van Lancker Sidtis, Diana14916420820210301Academic Search Complete",Article | Do Singing and Talking Arise From the Same or Different Neurological Systems Dissociations of Pitch Timing and Rhythm in Two Dysprosodic Singers. | Van Lancker Sidtis Diana 2021 Mar 01 | Published in Journal Psychomusicology Music Mind Volume 31 Issue 1 Page 18. | ISSN:0275-3987,4,0,0,4,4,8,50,50,0,0,0,0,0
"getit.library.nyu.edu/resolve?genre=article&isbn=&issn=02761467&title=JOURNAL OF MACROMARKETING&volume=35&issue=1&date=20150301&atitle=Disney as Environmental Steward? That's Just Goofy: A Critical Examination of the Relationship Between Magic, Sustainability and Corporate Practice&aulast=Coleman, Catherine A.&spage=143&sid=EBSCO:Social Sciences Citation Index&pid=Coleman, Catherine A.00034962360009320150301Social Sciences Citation Index",Article | Disney as Environmental Steward That's Just Goofy A Critical Examination of the Relationship Between Magic Sustainability and Corporate Practice | Coleman Catherine A 2015 Mar 01 | Published in Journal JOURNAL OF MACROMARKETING Volume 35 Issue 1 Page 143. | ISSN:0276-1467,1,0,0,1,1,2,50,50,0,0,0,0,0
"getit.library.nyu.edu/resolve?genre=article&isbn=&issn=03014797&title=Journal of Environmental Management&volume=288&issue=&date=20210615&atitle=An overview of brine management: Emerging desalination technologies, life cycle assessment, and metal recovery methodologies.&aulast=Bello, Adewale S.&spage=N.PAG&sid=EBSCO:Biological & Agricultural Index Plus (H.W. Wilson)=&pid=Bello, Adewale S.14992169020210615Biological & Agricultural Index Plus (H.W. Wilson)=",Article | An overview of brine management Emerging desalination technologies life cycle assessment and metal recovery methodologies. | Bello Adewale S 2021 Jun 15 | Published in Journal Journal of Environmental Management Volume 288 Page N.PAG. | ISSN:0301-4797,1,0,0,1,1,2,50,50,0,0,0,0,0
"getit.library.nyu.edu/resolve?genre=article&isbn=&issn=03014797&title=Journal of Environmental Management&volume=304&issue=&date=20220215&atitle=Research on the coordinated development of ecosystem services and well-being in agricultural and pastoral areas&aulast=Yang, Hai-Jiang&spage=&sid=EBSCO:ScienceDirect&pid=Yang, Hai-JiangS030147972102362820220215ScienceDirect",Article | Research on the coordinated development of ecosystem services and well-being in agricultural and pastoral areas | Yang Hai-Jiang 2022 Feb 15 | Published in Journal Journal of Environmental Management Volume 304. | ISSN:0301-4797,1,0,0,1,1,2,50,50,0,0,0,0,0
"getit.library.nyu.edu/resolve?genre=article&isbn=&issn=03017605&title=Critique: Journal of Socialist Theory&volume=39&issue=3&date=20110801&atitle=A Marxist Interpretation of the Dystopian Society in the African Novel.&aulast=Afolayan, Sola&spage=341&sid=EBSCO:Complementary Index&pid=Afolayan, Sola6259646720110801Complementary Index",Article | A Marxist Interpretation of the Dystopian Society in the African Novel. | Afolayan Sola 2011 Aug 01 | Published in Journal Critique Journal of Socialist Theory Volume 39 Issue 3 Page 341. | ISSN:0301-7605,1,0,0,1,1,2,50,50,0,0,0,0,0
"getit.library.nyu.edu/resolve?genre=article&isbn=&issn=03029743&title=Lecture notes in computer science&volume=12720&issue=&date=20210101&atitle=Assessing Bias in YouTube's Video Recommendation Algorithm in a Cross-lingual and Cross-topical Context&aulast=Kirdemir, Baris&spage=71&sid=EBSCO:British Library Document Supply Centre Inside Serials & Conference Proceedings=&pid=Kirdemir, BarisCN60693161820210101British Library Document Supply Centre Inside Serials & Conference Proceedings=",Article | Assessing Bias in YouTube's Video Recommendation Algorithm in a Cross-lingual and Cross-topical Context | Kirdemir Baris 2021 Jan 01 | Published in Journal Lecture notes in computer science Volume 12720 Page 71. | ISSN:0302-9743,1,0,0,1,1,2,50,50,0,0,0,0,0
"getit.library.nyu.edu/resolve?genre=article&isbn=&issn=03042340&title=Revista da Faculdade de Direito da Universidade Federal de Minas Gerais&volume=60&issue=&date=20120101&atitle=Human Rights and Democracy - Utopia or Reality&aulast=da Costa, Mara Nunes&spage=269&sid=EBSCO:HeinOnline&pid=da Costa, Mara Nunesedshol.hein.journals.rvufmg60.1320120101HeinOnline",Article | Human Rights and Democracy Utopia or Reality | Da Costa Mara Nunes 2012 Jan 01 | Published in Journal Revista da Faculdade de Direito da Universidade Federal de Minas Gerais Volume 60 Page 269. | ISSN:0304-2340,1,0,0,1,1,2,50,50,0,0,0,0,0
"getit.library.nyu.edu/resolve?genre=article&isbn=&issn=03044092&title=Dialectical Anthropology&volume=42&issue=2&date=20180601&atitle=Antiracism: a neoliberal alternative to a Left.&aulast=Reed, Adolph&spage=105&sid=EBSCO:Alternative Press Index&pid=Reed, AdolphALTP98438220180601Alternative Press Index",Article | Antiracism a neoliberal alternative to a Left. | Reed Adolph 2018 Jun 01 | Published in Journal Dialectical Anthropology Volume 42 Issue 2 Page 105. | ISSN:0304-4092,0,0,3,0,3,3,0,100,0,0,0,0,0
"getit.library.nyu.edu/resolve?genre=article&isbn=&issn=03054403&title=Journal of Archaeological Science&volume=97&issue=&date=20180901&atitle=On the origins of tin-opacified ceramic glazes: New evidence from early Islamic Egypt, the Levant, Mesopotamia, Iran, and Central Asia&aulast=Matin, Moujan&spage=42&sid=EBSCO:ScienceDirect&pid=Matin, MoujanS030544031830345520180901ScienceDirect",Article | On the origins of tin-opacified ceramic glazes New evidence from early Islamic Egypt the Levant Mesopotamia Iran and Central Asia | Matin Moujan 2018 Sep 01 | Published in Journal Journal of Archaeological Science Volume 97 Page 42. | ISSN:0305-4403,0,0,1,0,1,1,0,100,0,0,0,0,0
"getit.library.nyu.edu/resolve?genre=article&isbn=&issn=03057356&title=PSYCHOLOGY OF MUSIC&volume=49&issue=3&date=20210501&atitle=Popular music lyrics and musicians' gender over time: A computational approach&aulast=Anglada-Tort, Manuel&spage=426&sid=EBSCO:Arts & Humanities Citation Index=&pid=Anglada-Tort, Manuel00049212500000120210501Arts & Humanities Citation Index=",Article | Popular music lyrics and musicians gender over time A computational approach | Anglada Tort Manuel 2021 May 01 | Published in Journal PSYCHOLOGY OF MUSIC Volume 49 Issue 3 Page 426. | ISSN:0305-7356,1,0,0,1,1,2,50,50,0,0,0,0,0
"getit.library.nyu.edu/resolve?genre=article&isbn=&issn=0305750X&title=World Development&volume=127&issue=&date=20200301&atitle=Redefining the social contract in the wake of the Arab Spring: The experiences of Egypt, Morocco and Tunisia&aulast=El-Haddad, Amirah&spage=&sid=EBSCO:ScienceDirect&pid=El-Haddad, AmirahS0305750X1930423120200301ScienceDirect",Article | Redefining the social contract in the wake of the Arab Spring The experiences of Egypt Morocco and Tunisia | El Haddad Amirah 2020 Mar 01 | Published in Journal World Development Volume 127. | ISSN:0305-750X,1,0,0,1,1,2,50,50,0,0,0,0,0
"getit.library.nyu.edu/resolve?genre=article&isbn=&issn=03057925&title=COMPARE-A JOURNAL OF COMPARATIVE AND INTERNATIONAL EDUCATION&volume=&issue=&date=20210811&atitle=Does higher education expansion close the rural-urban gap in college enrolment in China? New evidence from a cross-provincial assessment&aulast=Zhao, Kai&spage=&sid=EBSCO:Social Sciences Citation Index&pid=Zhao, Kai00068408420000120210811Social Sciences Citation Index",Article | Does higher education expansion close the rural-urban gap in college enrolment in China New evidence from a cross-provincial assessment | Zhao Kai 2021 Aug 11 | Published in Journal COMPARE-A JOURNAL OF COMPARATIVE AND INTERNATIONAL EDUCATION. | ISSN:0305-7925,1,0,0,1,1,2,50,50,0,0,0,0,0
"getit.library.nyu.edu/resolve?genre=article&isbn=&issn=03058298&title=MILLENNIUM -LONDON- LONDON SCHOOL OF ECONOMICS-&volume=38&issue=1&date=20090101&atitle=`A Fresh Crop of Human Misery': Representations of Bosnian `War Babies' in the Global Print Media, 1991-2006&aulast=Carpenter, R.C.&spage=25&sid=EBSCO:British Library Document Supply Centre Inside Serials & Conference Proceedings=&pid=Carpenter, R.C.RN25599134620090101British Library Document Supply Centre Inside Serials & Conference Proceedings=",Article | `A Fresh Crop of Human Misery Representations of Bosnian War Babies in the Global Print Media 1991-2006 | Carpenter R C 2009 Jan 01 | Published in Journal MILLENNIUM LONDON LONDON SCHOOL OF ECONOMICS Volume 38 Issue 1 Page 25. | ISSN:0305-8298,1,0,0,1,1,2,50,50,0,0,0,0,0
"getit.library.nyu.edu/resolve?genre=article&isbn=&issn=03062619&title=Applied Energy&volume=260&issue=&date=20200215&atitle=Design of minimum cost degradation-conscious lithium-ion battery energy storage system to achieve renewable power dispatchability&aulast=Li, Yang&spage=&sid=EBSCO:ScienceDirect&pid=Li, YangS030626191931969520200215ScienceDirect",Article | Design of minimum cost degradation-conscious lithium-ion battery energy storage system to achieve renewable power dispatchability | Li Yang 2020 Feb 15 | Published in Journal Applied Energy Volume 260. | ISSN:0306-2619,1,0,0,1,1,2,50,50,0,0,0,0,0
"getit.library.nyu.edu/resolve?genre=article&isbn=&issn=03062619&title=Applied Energy&volume=262&issue=&date=20200315&atitle=Spatially-resolved urban energy systems model to study decarbonisation pathways for energy services in cities.&aulast=Jalil-Vega, Francisca&spage=N.PAG&sid=EBSCO:Environment Complete&pid=Jalil-Vega, Francisca14200637420200315Environment Complete",Article | Spatially-resolved urban energy systems model to study decarbonisation pathways for energy services in cities. | Jalil Vega Francisca 2020 Mar 15 | Published in Journal Applied Energy Volume 262 Page N.PAG. | ISSN:0306-2619,1,0,0,1,1,2,50,50,0,0,0,0,0
"getit.library.nyu.edu/resolve?genre=article&isbn=&issn=03064220&title=Index on Censorship&volume=45&issue=4&date=20161201&atitle=Baggy trousers are revolting: the {sans-culottes} of the French revolution transformed peasant dress into a badge of honour.&aulast=Werlin, Katy&spage=36&sid=EBSCO:Alternative Press Index&pid=Werlin, KatyALTP95408620161201Alternative Press Index",Article | Baggy trousers are revolting the sans-culottes of the French revolution transformed peasant dress into a badge of honour. | Werlin Katy 2016 Dec 01 | Published in Journal Index on Censorship Volume 45 Issue 4 Page 36. | ISSN:0306-4220,1,0,0,1,1,2,50,50,0,0,0,0,0
"getit.library.nyu.edu/resolve?genre=article&isbn=&issn=03064573&title=Information Processing and Management&volume=24&issue=1&date=19880101&atitle=The control revolution: Technological and economic origins of the information society: J. Beniger. Harvard University Press, Cambridge, MA (1986). x + 493 pp., $25.00, ISBN 0-674-16985-9.&aulast=Koenig, Michael E.D.&spage=104&sid=EBSCO:ScienceDirect&pid=Koenig, Michael E.D.030645738890082919880101ScienceDirect",Article | The control revolution Technological and economic origins of the information society J Beniger Harvard University Press Cambridge MA 1986 x 493 pp 25.00 ISBN 0-674-16985-9. | Koenig Michael E.D 1988 Jan 01 | Published in Journal Information Processing and Management Volume 24 Issue 1 Page 104. | ISSN:0306-4573,1,0,0,1,1,2,50,50,0,0,0,0,0
"getit.library.nyu.edu/resolve?genre=article&isbn=&issn=03064964&title=Foundation: The International Review of Science Fiction&volume=48&issue=&date=19900101&atitle=Difference and Desire, Slavery and Seduction: Octavia Butler's Xenogenesis&aulast=Bonner, Frances&spage=50&sid=EBSCO:MLA International Bibliography&pid=Bonner, Frances199003765719900101MLA International Bibliography",Article | Difference and Desire Slavery and Seduction Octavia Butler's Xenogenesis | Bonner Frances 1990 Jan 01 | Published in Journal Foundation The International Review of Science Fiction Volume 48 Page 50. | ISSN:0306-4964,1,0,0,1,1,2,50,50,0,0,0,0,0
"getit.library.nyu.edu/resolve?genre=article&isbn=&issn=0306610X&title=Crafts (0306610X)&volume=&issue=292&date=20220101&atitle=Visions of a lost future.&aulast=Adamson, Glenn&spage=86&sid=EBSCO:Art & Architecture Source=&pid=Adamson, Glenn15428268320220101Art & Architecture Source=",Article | Visions of a lost future. | Adamson Glenn 2022 Jan 01 | Published in Journal Crafts 0306610X Issue 292 Page 86. | ISSN:0306-610X,1,0,0,1,1,2,50,50,0,0,0,0,0
"getit.library.nyu.edu/resolve?genre=article&isbn=&issn=03066150&title=Journal of Peasant Studies&volume=48&issue=4&date=20210701&atitle=Rural revitalization, scholars, and the dynamics of the collective future in China.&aulast=Yan, Hairong&spage=853&sid=EBSCO:Complementary Index&pid=Yan, Hairong15098710820210701Complementary Index",Article | Rural revitalization scholars and the dynamics of the collective future in China. | Yan Hairong 2021 Jul 01 | Published in Journal Journal of Peasant Studies Volume 48 Issue 4 Page 853. | ISSN:0306-6150,1,0,0,1,1,2,50,50,0,0,0,0,0
"getit.library.nyu.edu/resolve?genre=article&isbn=&issn=03075133&title=Journal of Egyptian Archaeology&volume=104&issue=2&date=20181201&atitle=A Rare Example of Leather from Ancient Egypt.&aulast=Marazzi, Mary Ann&spage=211&sid=EBSCO:Art & Architecture Source=&pid=Marazzi, Mary Ann13954926520181201Art & Architecture Source=",Article | A Rare Example of Leather from Ancient Egypt. | Marazzi Mary Ann 2018 Dec 01 | Published in Journal Journal of Egyptian Archaeology Volume 104 Issue 2 Page 211. | ISSN:0307-5133,2,0,0,2,2,4,50,50,0,0,0,0,0
getit.library.nyu.edu/resolve?genre=article&isbn=&issn=03077578&title=Daily Mail&volume=&issue=&date=20210715&atitle=Mansplain rage.&aulast=&spage=60&sid=EBSCO:Supplemental Index&pid=15139009820210715Supplemental Index,Article | Mansplain rage. | 2021 Jul 15 | Published in Journal Daily Mail Page 60. | ISSN:0307-7578,10,1,0,11,10,21,52,48,0,0,0,0,0
getit.library.nyu.edu/resolve?genre=article&isbn=&issn=03077578&title=Daily Mail&volume=&issue=&date=20220322&atitle=Why exercise is so beneficial.&aulast=&spage=44&sid=EBSCO:Regional Business News&pid=15584928920220322Regional Business News,Article | Why exercise is so beneficial. | 2022 Mar 22 | Published in Journal Daily Mail Page 44. | ISSN:0307-7578,10,1,0,11,10,21,52,48,0,0,0,0,0
"getit.library.nyu.edu/resolve?genre=article&isbn=&issn=03080226&title=British Journal of Occupational Therapy&volume=82&issue=5&date=20190501&atitle=Treatment fidelity.&aulast=Hildebrand, Mary W&spage=261&sid=EBSCO:CINAHL Complete&pid=Hildebrand, Mary W13642254820190501CINAHL Complete",Article | Treatment fidelity. | Hildebrand Mary W 2019 May 01 | Published in Journal British Journal of Occupational Therapy Volume 82 Issue 5 Page 261. | ISSN:0308-0226,1,0,0,1,1,2,50,50,0,0,0,0,0
"getit.library.nyu.edu/resolve?genre=article&isbn=&issn=03080226&title=British journal of occupational therapy&volume=84&issue=7&date=20210101&atitle=The feasibility of a combined model of online interventions for adults with cancer-related cognitive impairment&aulast=Maeir, Talia&spage=430&sid=EBSCO:British Library Document Supply Centre Inside Serials & Conference Proceedings=&pid=Maeir, TaliaRN62676631420210101British Library Document Supply Centre Inside Serials & Conference Proceedings=",Article | The feasibility of a combined model of online interventions for adults with cancer-related cognitive impairment | Maeir Talia 2021 Jan 01 | Published in Journal British journal of occupational therapy Volume 84 Issue 7 Page 430. | ISSN:0308-0226,1,0,0,1,1,2,50,50,0,0,0,0,0
"getit.library.nyu.edu/resolve?genre=article&isbn=&issn=0308518X&title=Environment and Planning A&volume=44&issue=7&date=20120101&atitle=The queer time of creative urbanism: Family, futurity, and global city Singapore&aulast=Oswin, N.&spage=1624&sid=EBSCO:Scopus\u00ae&pid=Oswin, N.edselc.2-52.0-8486518759620120101Scopus\u00ae",Article | The queer time of creative urbanism Family futurity and global city Singapore | Oswin N 2012 Jan 01 | Published in Journal Environment and Planning A Volume 44 Issue 7 Page 1624. | ISSN:0308-518X,0,0,1,0,1,1,0,100,0,0,0,0,0
"getit.library.nyu.edu/resolve?genre=article&isbn=&issn=03087298&title=History of Photography&volume=34&issue=4&date=20101101&atitle=The History and Aesthetics of the Classical Film Still.&aulast=Jacobs, Steven&spage=373&sid=EBSCO:Complementary Index&pid=Jacobs, Steven5653683720101101Complementary Index",Article | The History and Aesthetics of the Classical Film Still. | Jacobs Steven 2010 Nov 01 | Published in Journal History of Photography Volume 34 Issue 4 Page 373. | ISSN:0308-7298,0,0,1,0,1,1,0,100,0,0,0,0,0
getit.library.nyu.edu/resolve?genre=article&isbn=&issn=03090566&title=European Journal of Marketing&volume=55&issue=2&date=20200905&atitle=The allure of starting afresh: the effects of mortality-related sadness on the effectiveness of fresh start appeals&aulast=Felix Septianto&spage=517&sid=EBSCO:Emerald Insight&pid=Felix Septiantoedsemr.10.1108.EJM.06.2019.054620200905Emerald Insight,Article | The allure of starting afresh the effects of mortality-related sadness on the effectiveness of fresh start appeals | Felix Septianto 2020 Sep 05 | Published in Journal European Journal of Marketing Volume 55 Issue 2 Page 517. | ISSN:0309-0566,2,0,0,2,2,4,50,50,0,0,0,0,0
"getit.library.nyu.edu/resolve?genre=article&isbn=&issn=03091317&title=International journal of urban and regional research&volume=45&issue=. 1&date=20210101&atitle=Day Zero and The Infrastructures of Climate Change : Water Governance, Inequality, and Infrastructural Politics in Cape Town's Water Crisis&aulast=Millington, Nate&spage=116&sid=EBSCO:Dialnet Plus&pid=Millington, Nateedsdnp.7695150ART20210101Dialnet Plus",Article | Day Zero and The Infrastructures of Climate Change Water Governance Inequality and Infrastructural Politics in Cape Town's Water Crisis | Millington Nate 2021 Jan 01 | Published in Journal International journal of urban and regional research Volume 45 Issue 1 Page 116. | ISSN:0309-1317,2,0,0,2,2,4,50,50,0,0,0,0,0
"getit.library.nyu.edu/resolve?genre=article&isbn=&issn=03150836&title=Canadian Theatre Review&volume=186&issue=&date=20210401&atitle=A Survivor's Guide to Institutional Racism.&aulast=Ba\u015far, Deniz&spage=39&sid=EBSCO:International Bibliography of Theatre & Dance with Full Text=&pid=Ba\u015far, Deniz14987942320210401International Bibliography of Theatre & Dance with Full Text=",Article | A Survivor's Guide to Institutional Racism. | Bau015far Deniz 2021 Apr 01 | Published in Journal Canadian Theatre Review Volume 186 Page 39. | ISSN:0315-0836,2,0,0,2,2,4,50,50,0,0,0,0,0
"getit.library.nyu.edu/resolve?genre=article&isbn=&issn=03337308&title=Israel Journal of Psychiatry and Related Sciences&volume=24&issue=4&date=19870101&atitle=Psychological distress of Holocaust survivors and offspring in Israel, forty years later: A review&aulast=Dasberg, H.&spage=243&sid=EBSCO:Scopus\u00ae&pid=Dasberg, H.edselc.2-52.0-002349368319870101Scopus\u00ae",Article | Psychological distress of Holocaust survivors and offspring in Israel forty years later A review | Dasberg H 1987 Jan 01 | Published in Journal Israel Journal of Psychiatry and Related Sciences Volume 24 Issue 4 Page 243. | ISSN:0333-7308,1,0,0,1,1,2,50,50,0,0,0,0,0
getit.library.nyu.edu/resolve?genre=article&isbn=&issn=03341763&title=Reviews in the neurosciences&volume=27&issue=4&date=20160601&atitle=Emotion regulation strategies in trauma-related disorders: pathways linking neurobiology and clinical manifestations.&aulast=Del R\u00edo-Casanova L&spage=385&sid=EBSCO:MEDLINE with Full Text&pid=Del R\u00edo-Casanova L2681278020160601MEDLINE with Full Text,Article | Emotion regulation strategies in trauma-related disorders pathways linking neurobiology and clinical manifestations. | Del R\u00edo-Casanova L 2016 Jun 01 | Published in Journal Reviews in the neurosciences Volume 27 Issue 4 Page 385. | ISSN:0334-1763,2,0,0,2,2,4,50,50,0,0,0,0,0
"getit.library.nyu.edu/resolve?genre=article&isbn=&issn=03400352&title=IFLA Journal&volume=48&issue=1&date=20220301&atitle=Prevalence and source analysis of COVID-19 misinformation in 138 countries.&aulast=Al-Zaman, Md. Sayeed&spage=189&sid=EBSCO:Library & Information Science Source=&pid=Al-Zaman, Md. Sayeed15573194720220301Library & Information Science Source=",Article | Prevalence and source analysis of COVID-19 misinformation in 138 countries. | Al Zaman Md Sayeed 2022 Mar 01 | Published in Journal IFLA Journal Volume 48 Issue 1 Page 189. | ISSN:0340-0352,2,0,0,2,2,4,50,50,0,0,0,0,0
"getit.library.nyu.edu/resolve?genre=article&isbn=&issn=03515796&title=International review of the aesthetics and sociology of music&volume=34&issue=2&date=20030101&atitle=Musical space and architectural time: Open scoring versus linear processes&aulast=Hanoch-Roe, Galia&spage=145&sid=EBSCO:RILM Abstracts of Music Literature with Full Text&pid=Hanoch-Roe, GaliaA51333320030101RILM Abstracts of Music Literature with Full Text",Article | Musical space and architectural time Open scoring versus linear processes | Hanoch Roe Galia 2003 Jan 01 | Published in Journal International review of the aesthetics and sociology of music Volume 34 Issue 2 Page 145. | ISSN:0351-5796,1,1,0,2,1,3,67,33,0,0,0,0,0
getit.library.nyu.edu/resolve?genre=article&isbn=&issn=03600572&title=Annual Review of Sociology&volume=38&issue=&date=20120101&atitle=Social and Economic Returns to College Education in the United States&aulast=Michael Hout&spage=379&sid=EBSCO:JSTOR Journals&pid=Michael Houtedsjsr.2325460120120101JSTOR Journals,Article | Social and Economic Returns to College Education in the United States | Michael Hout 2012 Jan 01 | Published in Journal Annual Review of Sociology Volume 38 Page 379. | ISSN:0360-0572,2,0,0,2,2,4,50,50,0,0,0,0,0
"getit.library.nyu.edu/resolve?genre=article&isbn=&issn=03600572&title=Annual Review of Sociology&volume=43&issue=1&date=20170701&atitle=Graduate Education and Social Stratification.&aulast=Posselt, Julie R.&spage=353&sid=EBSCO:Business Source Complete&pid=Posselt, Julie R.12439547820170701Business Source Complete",Article | Graduate Education and Social Stratification. | Posselt Julie R 2017 Jul 01 | Published in Journal Annual Review of Sociology Volume 43 Issue 1 Page 353. | ISSN:0360-0572,1,0,0,1,1,2,50,50,0,0,0,0,0
"getit.library.nyu.edu/resolve?genre=article&isbn=&issn=03600572&title=Annual Review of Sociology&volume=47&issue=1&date=20210701&atitle=Black Men and Black Masculinity.&aulast=Young Jr., Alford A.&spage=437&sid=EBSCO:Academic Search Complete&pid=Young Jr., Alford A.15168181020210701Academic Search Complete",Article | Black Men and Black Masculinity. | Young Jr Alford A 2021 Jul 01 | Published in Journal Annual Review of Sociology Volume 47 Issue 1 Page 437. | ISSN:0360-0572,0,0,1,0,1,1,0,100,0,0,0,0,0
"getit.library.nyu.edu/resolve?genre=article&isbn=&issn=03604039&title=Nursing&volume=51&issue=10&date=20211001&atitle=Nonpharmacologic approaches to pain management.&aulast=NATHENSON, PREM PAUL&spage=62&sid=EBSCO:Complementary Index&pid=NATHENSON, PREM PAUL15266160820211001Complementary Index",Article | Nonpharmacologic approaches to pain management. | Nathenson Prem Paul 2021 Oct 01 | Published in Journal Nursing Volume 51 Issue 10 Page 62. | ISSN:0360-4039,2,0,0,2,2,4,50,50,0,0,0,0,0
getit.library.nyu.edu/resolve?genre=article&isbn=&issn=03611817&title=The Nurse practitioner&volume=22&issue=10&date=19971001&atitle=Promoting healthy sexuality: guidelines for infancy through preschool.&aulast=Finan SL&spage=79&sid=EBSCO:MEDLINE with Full Text&pid=Finan SL935511819971001MEDLINE with Full Text,Article | Promoting healthy sexuality guidelines for infancy through preschool. | Finan SL 1997 Oct 01 | Published in Journal The Nurse practitioner Volume 22 Issue 10 Page 79. | ISSN:0361-1817,2,0,0,2,2,4,50,50,0,0,0,0,0
"getit.library.nyu.edu/resolve?genre=article&isbn=&issn=03611981&title=Transportation Research Record&volume=&issue=2216&date=20111201&atitle=Measuring and controlling subway fare evasion: Improving safety and security at New York City Transit Authority&aulast=Reddy, A.V.&spage=85&sid=EBSCO:Scopus\u00ae&pid=Reddy, A.V.edselc.2-52.0-8485612085420111201Scopus\u00ae",Article | Measuring and controlling subway fare evasion Improving safety and security at New York City Transit Authority | Reddy A V 2011 Dec 01 | Published in Journal Transportation Research Record Issue 2216 Page 85. | ISSN:0361-1981,1,0,0,1,1,2,50,50,0,0,0,0,0
"getit.library.nyu.edu/resolve?genre=article&isbn=&issn=03612317&title=Color: Research and applications&volume=29&issue=2&date=20040101&atitle=Museum Lighting: Optimizing the Illuminant&aulast=Abramov, I.&spage=121&sid=EBSCO:Dialnet Plus&pid=Abramov, I.edsdnp.817009ART20040101Dialnet Plus",Article | Museum Lighting Optimizing the Illuminant | Abramov I 2004 Jan 01 | Published in Journal Color Research and applications Volume 29 Issue 2 Page 121. | ISSN:0361-2317,1,0,0,1,1,2,50,50,0,0,0,0,0
"getit.library.nyu.edu/resolve?genre=article&isbn=&issn=03613682&title=Accounting, Organizations and Society&volume=81&issue=&date=20200201&atitle=Understanding financial auditing from a service perspective&aulast=Knechel, W. Robert&spage=&sid=EBSCO:ScienceDirect&pid=Knechel, W. RobertS036136821930072820200201ScienceDirect",Article | Understanding financial auditing from a service perspective | Knechel W Robert 2020 Feb 01 | Published in Journal Accounting Organizations and Society Volume 81. | ISSN:0361-3682,1,0,0,1,1,2,50,50,0,0,0,0,0
"getit.library.nyu.edu/resolve?genre=article&isbn=&issn=03616274&title=Health Care Management Review&volume=45&issue=3&date=20200701&atitle=Workplace violence: Examination of the tensions between duty of care, worker safety, and zero tolerance.&aulast=Beattie, Jill&spage=E13&sid=EBSCO:Supplemental Index&pid=Beattie, Jill14628976920200701Supplemental Index",Article | Workplace violence Examination of the tensions between duty of care worker safety and zero tolerance. | Beattie Jill 2020 Jul 01 | Published in Journal Health Care Management Review Volume 45 Issue 3 Page E13. | ISSN:0361-6274,1,0,0,1,1,2,50,50,0,0,0,0,0
"getit.library.nyu.edu/resolve?genre=article&isbn=&issn=03616843&title=Psychology of Women Quarterly&volume=44&issue=3&date=20200901&atitle=Facebook LGBTQ Pictivism: The Effects of Women's Rainbow Profile Filters on Sexual Prejudice and Online Belonging.&aulast=Matsick, Jes L.&spage=342&sid=EBSCO:Complementary Index&pid=Matsick, Jes L.14523891220200901Complementary Index",Article | Facebook LGBTQ Pictivism The Effects of Women's Rainbow Profile Filters on Sexual Prejudice and Online Belonging. | Matsick Jes L 2020 Sep 01 | Published in Journal Psychology of Women Quarterly Volume 44 Issue 3 Page 342. | ISSN:0361-6843,1,0,0,1,1,2,50,50,0,0,0,0,0
"getit.library.nyu.edu/resolve?genre=article&isbn=&issn=03616843&title=Psychology of Women Quarterly&volume=6&issue=3&date=19820301&atitle=FOR COLORED GIRLS WHO HAVE CONSIDERED SUICIDE WHEN THE RAINBOW IS ENUF (Book).&aulast=Smith, Eleanor&spage=367&sid=EBSCO:SocINDEX with Full Text&pid=Smith, Eleanor864643619820301SocINDEX with Full Text",Article | FOR COLORED GIRLS WHO HAVE CONSIDERED SUICIDE WHEN THE RAINBOW IS ENUF Book  | Smith Eleanor 1982 Mar 01 | Published in Journal Psychology of Women Quarterly Volume 6 Issue 3 Page 367. | ISSN:0361-6843,1,0,0,1,1,2,50,50,0,0,0,0,0
"getit.library.nyu.edu/resolve?genre=article&isbn=&issn=03623319&title=Social Science Journal&volume=53&issue=4&date=20161201&atitle=Regret among tattooed adolescents.&aulast=Dukes, Richard L.&spage=455&sid=EBSCO:Social Sciences Full Text (H.W. Wilson)&pid=Dukes, Richard L.11922077320161201Social Sciences Full Text (H.W. Wilson)",Article | Regret among tattooed adolescents. | Dukes Richard L 2016 Dec 01 | Published in Journal Social Science Journal Volume 53 Issue 4 Page 455. | ISSN:0362-3319,2,0,0,2,2,4,50,50,0,0,0,0,0
"getit.library.nyu.edu/resolve?genre=article&isbn=&issn=03624331&title=New York Times&volume=156&issue=53862&date=20070221&atitle=In the Land of Flamenco, Civil War's Buried Bones.&aulast=Grimes, William&spage=E10&sid=EBSCO:Regional Business News&pid=Grimes, William2439761720070221Regional Business News",Article | In the Land of Flamenco Civil War's Buried Bones. | Grimes William 2007 Feb 21 | Published in Journal New York Times Volume 156 Issue 53862 Page E10. | ISSN:0362-4331,6,1,0,7,6,13,54,46,0,0,0,0,0
"getit.library.nyu.edu/resolve?genre=article&isbn=&issn=03624331&title=New York Times&volume=161&issue=55805&date=20120617&atitle=Evolution Of a Feisty Pixar Princess.&aulast=Murphy, Mekado&spage=14&sid=EBSCO:Readers' Guide Full Text Mega (H.W. Wilson)&pid=Murphy, Mekado7659434920120617Readers' Guide Full Text Mega (H.W. Wilson)",Article | Evolution Of a Feisty Pixar Princess. | Murphy Mekado 2012 Jun 17 | Published in Journal New York Times Volume 161 Issue 55805 Page 14. | ISSN:0362-4331,7,2,0,9,7,16,56,44,0,0,0,0,0
"getit.library.nyu.edu/resolve?genre=article&isbn=&issn=03624331&title=New York Times&volume=162&issue=56049&date=20130216&atitle=Cambodia Sees Ethical Conflict In Import Panel.&aulast=MASHBERG, TOM&spage=C1&sid=EBSCO:Readers' Guide Full Text Mega (H.W. Wilson)&pid=MASHBERG, TOM8549775220130216Readers' Guide Full Text Mega (H.W. Wilson)",Article | Cambodia Sees Ethical Conflict In Import Panel. | Mashberg Tom 2013 Feb 16 | Published in Journal New York Times Volume 162 Issue 56049 Page C1. | ISSN:0362-4331,7,2,0,9,7,16,56,44,0,0,0,0,0
getit.library.nyu.edu/resolve?genre=article&isbn=&issn=03624331&title=New York Times&volume=168&issue=58129&date=20181028&atitle=South.&aulast=&spage=15&sid=EBSCO:Readers' Guide Full Text Mega (H.W. Wilson)&pid=13269365620181028Readers' Guide Full Text Mega (H.W. Wilson),Article | South. | 2018 Oct 28 | Published in Journal New York Times Volume 168 Issue 58129 Page 15. | ISSN:0362-4331,7,2,0,9,7,16,56,44,0,0,0,0,0
"getit.library.nyu.edu/resolve?genre=article&isbn=&issn=03624331&title=New York Times&volume=168&issue=58263&date=20190311&atitle=They Loved 'Us': Jordan Peele's Film Is a Hit at SXSW.&aulast=MURPHY, MEKADO&spage=C6&sid=EBSCO:Readers' Guide Full Text Mega (H.W. Wilson)&pid=MURPHY, MEKADO13520497620190311Readers' Guide Full Text Mega (H.W. Wilson)",Article | They Loved Us Jordan Peele's Film Is a Hit at SXSW. | Murphy Mekado 2019 Mar 11 | Published in Journal New York Times Volume 168 Issue 58263 Page C6. | ISSN:0362-4331,7,2,0,9,7,16,56,44,0,0,0,0,0
"getit.library.nyu.edu/resolve?genre=article&isbn=&issn=03624331&title=New York Times&volume=171&issue=59362&date=20220314&atitle=An Exiled Theater Has a Warning for Europe.&aulast=MARSHALL, ALEX&spage=C6&sid=EBSCO:Newspaper Source Plus&pid=MARSHALL, ALEX15574086820220314Newspaper Source Plus",Article | An Exiled Theater Has a Warning for Europe. | Marshall Alex 2022 Mar 14 | Published in Journal New York Times Volume 171 Issue 59362 Page C6. | ISSN:0362-4331,0,0,7,0,7,7,0,100,0,0,0,0,0
"getit.library.nyu.edu/resolve?genre=article&isbn=&issn=03630234&title=Suicide & Life-Threatening Behavior=&volume=51&issue=4&date=20210801&atitle=Implementing the interpersonal theory of suicide to improve outcomes in suicidal adolescents: A pilot trial.&aulast=Zullo, Lucas&spage=633&sid=EBSCO:Criminal Justice Abstracts with Full Text&pid=Zullo, Lucas15205769720210801Criminal Justice Abstracts with Full Text",Article | Implementing the interpersonal theory of suicide to improve outcomes in suicidal adolescents A pilot trial. | Zullo Lucas 2021 Aug 01 | Published in Journal Suicide Volume 51 Issue 4 Page 633. | ISSN:0363-0234,2,0,0,2,2,4,50,50,0,0,0,0,0
"getit.library.nyu.edu/resolve?genre=article&isbn=&issn=03630242&title=Women & health=&volume=56&issue=6&date=20160101&atitle=Racial comparisons in perceptions of maternal and peer attitudes, body dissatisfaction, and eating disorders among African American and White women&aulast=Javier, Sarah J.&spage=615&sid=EBSCO:British Library Document Supply Centre Inside Serials & Conference Proceedings=&pid=Javier, Sarah J.vdc.100033759165.0x00000120160101British Library Document Supply Centre Inside Serials & Conference Proceedings=",Article | Racial comparisons in perceptions of maternal and peer attitudes body dissatisfaction and eating disorders among African American and White women | Javier Sarah J 2016 Jan 01 | Published in Journal Women Volume 56 Issue 6 Page 615. | ISSN:0363-0242,1,0,0,1,1,2,50,50,0,0,0,0,0
"getit.library.nyu.edu/resolve?genre=article&isbn=&issn=03633624&title=Nurse Educator&volume=44&issue=3&date=20190501&atitle=Emotional Intelligence Relates to NCLEX and Standardized Readiness Test: A Pilot Study.&aulast=Rode, Jennifer&spage=154&sid=EBSCO:CINAHL Complete&pid=Rode, Jennifer13620414620190501CINAHL Complete",Article | Emotional Intelligence Relates to NCLEX and Standardized Readiness Test A Pilot Study. | Rode Jennifer 2019 May 01 | Published in Journal Nurse Educator Volume 44 Issue 3 Page 154. | ISSN:0363-3624,0,0,2,0,2,2,0,100,0,0,0,0,0
"getit.library.nyu.edu/resolve?genre=article&isbn=&issn=03641287&title=Army Lawyer&volume=2019&issue=4&date=20190101&atitle=The Abu Ghraib Trials, 15 Years Later&aulast=Crawford, Jennifer L.&spage=48&sid=EBSCO:HeinOnline&pid=Crawford, Jennifer L.edshol.hein.journals.armylaw2019.7620190101HeinOnline",Article | The Abu Ghraib Trials 15 Years Later | Crawford Jennifer L 2019 Jan 01 | Published in Journal Army Lawyer Volume 2019 Issue 4 Page 48. | ISSN:0364-1287,5,0,1,5,6,11,45,55,0,0,0,0,0
"getit.library.nyu.edu/resolve?genre=article&isbn=&issn=03682048&title=Journal of Electron Spectroscopy and Related Phenomena&volume=185&issue=3-4&date=20120401&atitle=A XANES study of cobalt speciation state in blue-and-white glazes from 16th to 17th century Chinese porcelains&aulast=Figueiredo, M.O.&spage=97&sid=EBSCO:ScienceDirect&pid=Figueiredo, M.O.S036820481200026620120401ScienceDirect",Article | A XANES study of cobalt speciation state in blue-and-white glazes from 16th to 17th century Chinese porcelains | Figueiredo M O 2012 Apr 01 | Published in Journal Journal of Electron Spectroscopy and Related Phenomena Volume 185 Issue 3-4 Page 97. | ISSN:0368-2048,1,0,0,1,1,2,50,50,0,0,0,0,0
"getit.library.nyu.edu/resolve?genre=article&isbn=&issn=03701573&title=Physics Reports&volume=857&issue=&date=20200503&atitle=Effective field theory of dark energy: A review&aulast=Frusciante, Noemi&spage=1&sid=EBSCO:ScienceDirect&pid=Frusciante, NoemiS037015732030037520200503ScienceDirect",Article | Effective field theory of dark energy A review | Frusciante Noemi 2020 May 03 | Published in Journal Physics Reports Volume 857 Page 1. | ISSN:0370-1573,1,0,0,1,1,2,50,50,0,0,0,0,0
"getit.library.nyu.edu/resolve?genre=article&isbn=&issn=03768716&title=DRUG AND ALCOHOL DEPENDENCE&volume=187&issue=&date=20180601&atitle=Concurrent use of alcohol with other drugs and DSM-5 alcohol use disorder comorbid with other drug use disorders: Sociodemographic characteristics, severity, and psychopathology&aulast=Saha, Tulshi D.&spage=261&sid=EBSCO:Science Citation Index Expanded&pid=Saha, Tulshi D.00043688570004020180601Science Citation Index Expanded",Article | Concurrent use of alcohol with other drugs and DSM-5 alcohol use disorder comorbid with other drug use disorders Sociodemographic characteristics severity and psychopathology | Saha Tulshi D 2018 Jun 01 | Published in Journal DRUG AND ALCOHOL DEPENDENCE Volume 187 Page 261. | ISSN:0376-8716,1,0,0,1,1,2,50,50,0,0,0,0,0
"getit.library.nyu.edu/resolve?genre=article&isbn=&issn=03772217&title=European Journal of Operational Research&volume=297&issue=3&date=20220316&atitle=Intertemporal defaulted bond recoveries prediction via machine learning.&aulast=Nazemi, Abdolreza&spage=1162&sid=EBSCO:Business Source Complete&pid=Nazemi, Abdolreza15362253420220316Business Source Complete",Article | Intertemporal defaulted bond recoveries prediction via machine learning. | Nazemi Abdolreza 2022 Mar 16 | Published in Journal European Journal of Operational Research Volume 297 Issue 3 Page 1162. | ISSN:0377-2217,0,0,1,0,1,1,0,100,0,0,0,0,0
"getit.library.nyu.edu/resolve?genre=article&isbn=&issn=0439755X&title=\u5fc3\u7406\u5b66\u62a5 / ACTA PSYCHOLOGICA SINICA&volume=40&issue=10&date=20080101&atitle=\u9057\u4f20\u3001\u73af\u5883\u548c\u9752\u5c11\u5e74\u7684\u5438\u70df\u996e\u9152\u884c\u4e3a:\u82ac\u5170\u53cc\u751f\u5b50\u7814\u7a76\u7684\u56de\u6eaf\u4e0e\u524d\u77bb / Genes, Environments, and Adolescent Substance Use:Retrospect and Prospect from the FinnTwin Studies&aulast=Richard J. Rose&spage=1062&sid=EBSCO:China Online Journals (Wanfang)&pid=Richard J. Roseedscoj.xlxb20081000420080101China Online Journals (Wanfang)",Article | \u9057\u4f20\u3001\u73af\u5883\u548c\u9752\u5c11\u5e74\u7684\u5438\u70df\u996e\u9152\u884c\u4e3a u82ac\u5170\u53cc\u751f\u5b50\u7814\u7a76\u7684\u56de\u6eaf\u4e0e\u524d\u77bb Genes Environments and Adolescent Substance Use:Retrospect and Prospect from the FinnTwin Studies | Richard J Rose 2008 Jan 01 | Published in Journal u5fc3\u7406\u5b66\u62a5 ACTA PSYCHOLOGICA SINICA Volume 40 Issue 10 Page 1062. | ISSN:0439-755X,1,0,0,1,1,2,50,50,0,0,0,0,0
getit.library.nyu.edu/resolve?genre=article&isbn=&issn=04955692&title=\u7535\u5f71\u6587\u5b66 / Movie Literature&volume=&issue=23&date=20100101&atitle=\u4ece\u6297\u65e5\u5c0f\u8bf4\u4e2d\u7684\u5973\u6027\u8d1e\u64cd\u89c2\u5ff5\u770b\u5b59\u7281\u7684\u7537\u6743\u610f\u8bc6&aulast=&spage=128&sid=EBSCO:China/Asia On Demand&pid=edsocd.caod.312120102306320100101China/Asia On Demand,Article | \u4ece\u6297\u65e5\u5c0f\u8bf4\u4e2d\u7684\u5973\u6027\u8d1e\u64cd\u89c2\u5ff5\u770b\u5b59\u7281\u7684\u7537\u6743\u610f\u8bc6 | 2010 Jan 01 | Published in Journal u7535\u5f71\u6587\u5b66 Movie Literature Issue 23 Page 128. | ISSN:0495-5692,1,0,0,1,1,2,50,50,0,0,0,0,0
getit.library.nyu.edu/resolve?genre=article&isbn=&issn=05114772&title=\u6587\u7269 / Cultural Relics&volume=&issue=6&date=20140101&atitle=\u79e6\u4eba\u7684\u5341\u4e2a\u9675\u533a&aulast=\u7126\u5357\u5cf0 \u5b59\u4f1f\u521a \u675c\u6797\u6e0a&spage=64&sid=EBSCO:China Science & Technology Journal Database=&pid=\u7126\u5357\u5cf0 \u5b59\u4f1f\u521a \u675c\u6797\u6e0aedscqv.4991811720140101China Science & Technology Journal Database=,Article | \u79e6\u4eba\u7684\u5341\u4e2a\u9675\u533a | \u7126\u5357\u5cf0 u5b59\u4f1f\u521a u675c\u6797\u6e0a 2014 Jan 01 | Published in Journal u6587\u7269 Cultural Relics Issue 6 Page 64. | ISSN:0511-4772,1,0,0,1,1,2,50,50,0,0,0,0,0
"getit.library.nyu.edu/resolve?genre=article&isbn=&issn=05296498&title=\u4e2d\u570b\u5730\u65b9\u81ea\u6cbb&volume=74&issue=9&date=20210901&atitle=\u5927\u6578\u64da\u8996\u89d2\u4e0b\u7684\u516c\u5171\u653f\u7b56\uff0d\u7db2\u8def\u8f3f\u60c5\u5206\u6790\u65b9\u6cd5\u4e4b\u61c9\u7528\u8207\u767c\u5c55 / Public Policy from the Big Data Perspective-The Application and Development of Internet Public Opinion Analysis&aulast=\u90ed\u6bd3\u502b / Kyle, Yulun Kuo&spage=3&sid=EBSCO:Airiti Library eBooks & Journals - \u83ef\u85dd\u7dda\u4e0a\u5716\u66f8\u9928=&pid=\u90ed\u6bd3\u502b / Kyle, Yulun Kuoedsarl.a0000015.202109.202109290001.202109290001.3.3520210901Airiti Library eBooks & Journals - \u83ef\u85dd\u7dda\u4e0a\u5716\u66f8\u9928=",Article | \u5927\u6578\u64da\u8996\u89d2\u4e0b\u7684\u516c\u5171\u653f\u7b56\uff0d\u7db2\u8def\u8f3f\u60c5\u5206\u6790\u65b9\u6cd5\u4e4b\u61c9\u7528\u8207\u767c\u5c55 Public Policy from the Big Data Perspective-The Application and Development of Internet Public Opinion Analysis | \u90ed\u6bd3\u502b Kyle Yulun Kuo 2021 Sep 01 | Published in Journal u4e2d\u570b\u5730\u65b9\u81ea\u6cbb Volume 74 Issue 9 Page 3. | ISSN:0529-6498,1,0,0,1,1,2,50,50,0,0,0,0,0
"getit.library.nyu.edu/resolve?genre=article&isbn=&issn=07031459&title=Canadian Journal of Irish Studies/Revue Canadienne d'Etudes Irlandaises&volume=1&issue=1&date=20150101&atitle=Revisiting the Other: National Theatre of Scotland and the Mythologization of the Highlands and Islands&aulast=\u015aledzi\u0144ska, Paula&spage=118&sid=EBSCO:MLA International Bibliography&pid=\u015aledzi\u0144ska, Paula201958375420150101MLA International Bibliography",Article | Revisiting the Other National Theatre of Scotland and the Mythologization of the Highlands and Islands | U015aledziu0144ska Paula 2015 Jan 01 | Published in Journal Canadian Journal of Irish Studies/Revue Canadienne d'Etudes Irlandaises Volume 1 Issue 1 Page 118. | ISSN:0703-1459,2,0,0,2,2,4,50,50,0,0,0,0,0
"getit.library.nyu.edu/resolve?genre=article&isbn=&issn=07038968&title=Briarpatch&volume=45&issue=4&date=20160701&atitle=Pinkwashing settler colonialism: how settler-colonial states co-opt gay rights to legitimize occupation.&aulast=Zak, Emily&spage=12&sid=EBSCO:Alternative Press Index&pid=Zak, EmilyALTP94719520160701Alternative Press Index",Article | Pinkwashing settler colonialism how settler-colonial states co-opt gay rights to legitimize occupation. | Zak Emily 2016 Jul 01 | Published in Journal Briarpatch Volume 45 Issue 4 Page 12. | ISSN:0703-8968,4,0,0,4,4,8,50,50,0,0,0,0,0
"getit.library.nyu.edu/resolve?genre=article&isbn=&issn=07176228&title=Revista chilena de pediatria&volume=88&issue=4&date=20170101&atitle=[Breastfeeding, gross motor development and obesity, is there any causal association?]&aulast=Weisstaub N G&spage=451&sid=EBSCO:MEDLINE with Full Text&pid=Weisstaub N G2889831120170101MEDLINE with Full Text",Article | [Breastfeeding gross motor development and obesity is there any causal association  | Weisstaub N G 2017 Jan 01 | Published in Journal Revista chilena de pediatria Volume 88 Issue 4 Page 451. | ISSN:0370-4106,0,0,1,0,1,1,0,100,0,0,0,0,0
"getit.library.nyu.edu/resolve?genre=article&isbn=&issn=07235186&title=FEMINISTISCHE STUDIEN&volume=37&issue=2&date=20191101&atitle=Cyborgs revisited: Connecting between Gender, Technologies and Machines&aulast=Berscheid, Anna Lena&spage=241&sid=EBSCO:Social Sciences Citation Index&pid=Berscheid, Anna Lena00051048320000120191101Social Sciences Citation Index",Article | Cyborgs revisited Connecting between Gender Technologies and Machines | Berscheid Anna Lena 2019 Nov 01 | Published in Journal FEMINISTISCHE STUDIEN Volume 37 Issue 2 Page 241. | ISSN:0723-5186,1,0,0,1,1,2,50,50,0,0,0,0,0
"getit.library.nyu.edu/resolve?genre=article&isbn=&issn=07301383&title=Teaching History: A Journal of Methods&volume=43&issue=1&date=20180301&atitle=STIMULATING STUDENT MORAL ENGAGEMENT IN THE SERVICE OF CIVIC EDUCATION.&aulast=Gerber, David&spage=18&sid=EBSCO:Education Source&pid=Gerber, David13062464720180301Education Source",Article | STIMULATING STUDENT MORAL ENGAGEMENT IN THE SERVICE OF CIVIC EDUCATION. | Gerber David 2018 Mar 01 | Published in Journal Teaching History A Journal of Methods Volume 43 Issue 1 Page 18. | ISSN:0730-1383,0,0,1,0,1,1,0,100,0,0,0,0,0
"getit.library.nyu.edu/resolve?genre=article&isbn=&issn=07303084&title=Journal of Physical Education, Recreation & Dance (JOPERD)=&volume=79&issue=4&date=20080401&atitle=Preserving Our Legacy for Future Generations of Educators&aulast=Hearn, Colleen Porter&spage=18&sid=EBSCO:ERIC&pid=Hearn, Colleen PorterEJ80756220080401ERIC",Article | Preserving Our Legacy for Future Generations of Educators | Hearn Colleen Porter 2008 Apr 01 | Published in Journal Journal of Physical Education Recreation Volume 79 Issue 4 Page 18. | ISSN:0730-3084,6,0,0,6,6,12,50,50,0,0,0,0,0
"getit.library.nyu.edu/resolve?genre=article&isbn=&issn=07334648&title=Journal of Applied Gerontology&volume=41&issue=2&date=20220201&atitle=Examining Racial Differences in the Informal Discussion of Advance Care Planning Among Older Adults: Application of the Andersen Model of Health Care Utilization&aulast=Suntai, Zainab&spage=371&sid=EBSCO:AgeLine&pid=Suntai, ZainabEP15489879620220201AgeLine",Article | Examining Racial Differences in the Informal Discussion of Advance Care Planning Among Older Adults Application of the Andersen Model of Health Care Utilization | Suntai Zainab 2022 Feb 01 | Published in Journal Journal of Applied Gerontology Volume 41 Issue 2 Page 371. | ISSN:0733-4648,0,0,1,0,1,1,0,100,0,0,0,0,0
getit.library.nyu.edu/resolve?genre=article&isbn=&issn=07346018&title=Representations&volume=&issue=37&date=19920101&atitle=Postcoloniality and the Artifice of History: Who Speaks for \,Article | Postcoloniality and the Artifice of History Who Speaks for  | 1992 Jan 01 | Published in Journal Representations Issue 37. | ISSN:0734-6018,1,0,0,1,1,2,50,50,0,0,0,0,0
"getit.library.nyu.edu/resolve?genre=article&isbn=&issn=07346018&title=Representations&volume=77&issue=1&date=20020101&atitle=In a Sacramental Mode: Jean de L\u00e9ry's Calvinist Ethnography.&aulast=Frisch, Andrea&spage=82&sid=EBSCO:Historical Abstracts with Full Text&pid=Frisch, Andrea650329320020101Historical Abstracts with Full Text",Article | In a Sacramental Mode Jean de L\u00e9ry's Calvinist Ethnography. | Frisch Andrea 2002 Jan 01 | Published in Journal Representations Volume 77 Issue 1 Page 82. | ISSN:0734-6018,0,0,5,0,5,5,0,100,0,0,0,0,0
"getit.library.nyu.edu/resolve?genre=article&isbn=&issn=07346875&title=MUSIC THERAPY PERSPECTIVES&volume=19&issue=1&date=20010101&atitle=In Search of the Self: The Use of Vocal Holding Techniques with Adults Traumatized as Children&aulast=Austin, D.&spage=22&sid=EBSCO:British Library Document Supply Centre Inside Serials & Conference Proceedings=&pid=Austin, D.RN10042328520010101British Library Document Supply Centre Inside Serials & Conference Proceedings=",Article | In Search of the Self The Use of Vocal Holding Techniques with Adults Traumatized as Children | Austin D 2001 Jan 01 | Published in Journal MUSIC THERAPY PERSPECTIVES Volume 19 Issue 1 Page 22. | ISSN:0734-6875,1,0,0,1,1,2,50,50,0,0,0,0,0
"getit.library.nyu.edu/resolve?genre=article&isbn=&issn=07363761&title=Journal of Consumer Marketing&volume=16&issue=6&date=19991201&atitle=Environmental segmentation alternatives&colon; a look at green consumer behavior in the new millennium=&aulast=Straughan, Robert D.&spage=558&sid=EBSCO:Emerald Insight&pid=Straughan, Robert D.edsemr.10.1108.0736376991029750619991201Emerald Insight",Article | Environmental segmentation alternatives | Straughan Robert D 1999 Dec 01 | Published in Journal Journal of Consumer Marketing Volume 16 Issue 6 Page 558. | ISSN:0736-3761,2,0,0,2,2,4,50,50,0,0,0,0,0
getit.library.nyu.edu/resolve?genre=article&isbn=&issn=07363761&title=Journal of Consumer Marketing&volume=38&issue=5&date=20210803&atitle=Accumulating capital through social media: the transformative power of underrepresented fashion consumers&aulast=Lena Cavusoglu&spage=514&sid=EBSCO:Emerald Insight&pid=Lena Cavusogluedsemr.10.1108.JCM.08.2020.407420210803Emerald Insight,Article | Accumulating capital through social media the transformative power of underrepresented fashion consumers | Lena Cavusoglu 2021 Aug 03 | Published in Journal Journal of Consumer Marketing Volume 38 Issue 5 Page 514. | ISSN:0736-3761,2,0,0,2,2,4,50,50,0,0,0,0,0
"getit.library.nyu.edu/resolve?genre=article&isbn=&issn=07369735&title=Psychoanalytic Psychology&volume=30&issue=3&date=20130701&atitle=Psychoanalytic applications in a diverse society&aulast=Tummala-Narra, P.&spage=471&sid=EBSCO:Scopus\u00ae&pid=Tummala-Narra, P.edselc.2-52.0-8488760417520130701Scopus\u00ae",Article | Psychoanalytic applications in a diverse society | Tummala Narra P 2013 Jul 01 | Published in Journal Psychoanalytic Psychology Volume 30 Issue 3 Page 471. | ISSN:0736-9735,2,0,0,2,2,4,50,50,0,0,0,0,0
"getit.library.nyu.edu/resolve?genre=article&isbn=&issn=07370873&title=Griot: Official Journal of the Southern Conference on Afro-American Studies, Inc.&volume=31&issue=2&date=20120101&atitle=Frederick Douglass's Journey from Slave to Freeman: An Acquisition and Mastery of Language, Rhetoric, and Power via the Narrative&aulast=Hansen, John&spage=14&sid=EBSCO:MLA International Bibliography&pid=Hansen, John201338036420120101MLA International Bibliography",Article | Frederick Douglass's Journey from Slave to Freeman An Acquisition and Mastery of Language Rhetoric and Power via the Narrative | Hansen John 2012 Jan 01 | Published in Journal Griot Official Journal of the Southern Conference on Afro-American Studies Inc Volume 31 Issue 2 Page 14. | ISSN:0737-0873,0,0,2,0,2,2,0,100,0,0,0,0,0
"getit.library.nyu.edu/resolve?genre=article&isbn=&issn=07383991&title=Patient Education and Counseling&volume=104&issue=7&date=20210701&atitle=Individual, interpersonal, and health care factors associated with informal and formal advance care planning in a nationally-representative sample of midlife and older adults&aulast=Siconolfi, Daniel&spage=1806&sid=EBSCO:ScienceDirect&pid=Siconolfi, DanielS073839912030687X20210701ScienceDirect",Article | Individual interpersonal and health care factors associated with informal and formal advance care planning in a nationally-representative sample of midlife and older adults | Siconolfi Daniel 2021 Jul 01 | Published in Journal Patient Education and Counseling Volume 104 Issue 7 Page 1806. | ISSN:0738-3991,0,0,1,0,1,1,0,100,0,0,0,0,0
"getit.library.nyu.edu/resolve?genre=article&isbn=&issn=07402775&title=World Policy Journal&volume=33&issue=4&date=20161201&atitle=RACIST IN THE MACHINE: THE DISTURBING IMPLICATIONS OF ALGORITHMIC BIAS.&aulast=GARCIA, MEGAN&spage=111&sid=EBSCO:Academic Search Complete&pid=GARCIA, MEGAN12082239720161201Academic Search Complete",Article | RACIST IN THE MACHINE THE DISTURBING IMPLICATIONS OF ALGORITHMIC BIAS. | Garcia Megan 2016 Dec 01 | Published in Journal World Policy Journal Volume 33 Issue 4 Page 111. | ISSN:0740-2775,4,0,0,4,4,8,50,50,0,0,0,0,0
"getit.library.nyu.edu/resolve?genre=article&isbn=&issn=07405472&title=Journal of Substance Abuse Treatment&volume=76&issue=&date=20170501&atitle=A group-based motivational interviewing brief intervention to reduce substance use and sexual risk behavior among homeless young adults&aulast=Tucker, Joan S.&spage=20&sid=EBSCO:ScienceDirect&pid=Tucker, Joan S.S074054721630326920170501ScienceDirect",Article | A group-based motivational interviewing brief intervention to reduce substance use and sexual risk behavior among homeless young adults | Tucker Joan S 2017 May 01 | Published in Journal Journal of Substance Abuse Treatment Volume 76 Page 20. | ISSN:0740-5472,0,0,1,0,1,1,0,100,0,0,0,0,0
"getit.library.nyu.edu/resolve?genre=article&isbn=&issn=07411235&title=Sociology of Sport Journal&volume=31&issue=4&date=20141201&atitle=Animal Blood Sport: A Ritual Display of Masculinity and Sexual Virility.&aulast=Kalof, Linda&spage=438&sid=EBSCO:SocINDEX with Full Text&pid=Kalof, Linda10064419020141201SocINDEX with Full Text",Article | Animal Blood Sport A Ritual Display of Masculinity and Sexual Virility. | Kalof Linda 2014 Dec 01 | Published in Journal Sociology of Sport Journal Volume 31 Issue 4 Page 438. | ISSN:0741-1235,0,0,2,0,2,2,0,100,0,0,0,0,0
"getit.library.nyu.edu/resolve?genre=article&isbn=&issn=07475632&title=Computers in Human Behavior&volume=80&issue=&date=20180301&atitle=Excessive use of online video streaming services: Impact of recommender system use, psychological factors, and motives&aulast=Hasan, Md Rajibul&spage=220&sid=EBSCO:ScienceDirect&pid=Hasan, Md RajibulS074756321730658120180301ScienceDirect",Article | Excessive use of online video streaming services Impact of recommender system use psychological factors and motives | Hasan Md Rajibul 2018 Mar 01 | Published in Journal Computers in Human Behavior Volume 80 Page 220. | ISSN:0747-5632,0,0,1,0,1,1,0,100,0,0,0,0,0
"getit.library.nyu.edu/resolve?genre=article&isbn=&issn=07487983&title=European Journal of Surgical Oncology&volume=45&issue=4&date=20190401&atitle=Quality indicators for the management of endometrial, cervical and ovarian cancer&aulast=Bonte, Anne-Sophie&spage=528&sid=EBSCO:ScienceDirect&pid=Bonte, Anne-SophieS074879831831451320190401ScienceDirect",Article | Quality indicators for the management of endometrial cervical and ovarian cancer | Bonte Anne-Sophie 2019 Apr 01 | Published in Journal European Journal of Surgical Oncology Volume 45 Issue 4 Page 528. | ISSN:0748-7983,0,0,1,0,1,1,0,100,0,0,0,0,0
getit.library.nyu.edu/resolve?genre=article&isbn=&issn=07489633&title=Journal of Counseling & Development=&volume=&issue=&date=&atitle=&aulast=&spage=&sid=EBSCO:Social Sciences Full Text (H.W. Wilson) Publications&pid=Social Sciences Full Text (H.W. Wilson) Publications,Article | Journal of Counseling |  | ISSN:0748-9633 | undefined,0,0,6,0,6,6,0,100,0,0,0,0,0
"getit.library.nyu.edu/resolve?genre=article&isbn=&issn=07491646&title=Thurgood Marshall Law Review&volume=45&issue=1&date=20200101&atitle=Gamble-Boxes and Micro-Theft-Actions: Why Loot Boxes and Microtransactions Should Be Banned from Video Games&aulast=Okereke, Wesley&spage=57&sid=EBSCO:HeinOnline&pid=Okereke, Wesleyedshol.hein.journals.thurlr45.820200101HeinOnline",Article | Gamble-Boxes and Micro-Theft-Actions Why Loot Boxes and Microtransactions Should Be Banned from Video Games | Okereke Wesley 2020 Jan 01 | Published in Journal Thurgood Marshall Law Review Volume 45 Issue 1 Page 57. | ISSN:0749-1646,3,0,0,3,3,6,50,50,0,0,0,0,0
"getit.library.nyu.edu/resolve?genre=article&isbn=&issn=08035253&title=Acta Paediatrica&volume=107&issue=2&date=20180201&atitle=Quality predictors of parental satisfaction after birth of infants with life-limiting conditions.&aulast=Wool, Charlotte&spage=276&sid=EBSCO:Complementary Index&pid=Wool, Charlotte12727277920180201Complementary Index",Article | Quality predictors of parental satisfaction after birth of infants with life-limiting conditions. | Wool Charlotte 2018 Feb 01 | Published in Journal Acta Paediatrica Volume 107 Issue 2 Page 276. | ISSN:0803-5253,1,0,0,1,1,2,50,50,0,0,0,0,0
"getit.library.nyu.edu/resolve?genre=article&isbn=&issn=08180628&title=Time International (South Pacific Edition)&volume=188&issue=8&date=20160829&atitle=Black and white America look to James Baldwin to unpin us all from history.&aulast=Glaude Jr., Eddie S.&spage=49&sid=EBSCO:Business Source Complete&pid=Glaude Jr., Eddie S.11761394520160829Business Source Complete",Article | Black and white America look to James Baldwin to unpin us all from history. | Glaude Jr Eddie S 2016 Aug 29 | Published in Journal Time International South Pacific Edition Volume 188 Issue 8 Page 49. | ISSN:0818-0628,1,0,0,1,1,2,50,50,0,0,0,0,0
"getit.library.nyu.edu/resolve?genre=article&isbn=&issn=08198691&title=History of Education Review&volume=50&issue=1&date=20201105&atitle=The National Defense Education Act, the American Association of University Professors and the dilemma of academic freedom in the mid-twentieth century&aulast=Huimin Wang&spage=67&sid=EBSCO:Emerald Insight&pid=Huimin Wangedsemr.10.1108.HER.10.2019.004320201105Emerald Insight",Article | The National Defense Education Act the American Association of University Professors and the dilemma of academic freedom in the mid-twentieth century | Huimin Wang 2020 Nov 05 | Published in Journal History of Education Review Volume 50 Issue 1 Page 67. | ISSN:0819-8691,3,0,0,3,3,6,50,50,0,0,0,0,0
"getit.library.nyu.edu/resolve?genre=article&isbn=&issn=08676046&title=Miscellanea Geographica: Regional Studies on Development&volume=20&issue=2&date=20160601&atitle=Predicting the Extent of Inundation due to Sea-Level Rise: Al Hamra Development, Ras Al Khaimah, UAE. A Pilot Project.&aulast=Arthur, Robert M.&spage=25&sid=EBSCO:Complementary Index&pid=Arthur, Robert M.11643158520160601Complementary Index",Article | Predicting the Extent of Inundation due to Sea-Level Rise Al Hamra Development Ras Al Khaimah UAE A Pilot Project. | Arthur Robert M 2016 Jun 01 | Published in Journal Miscellanea Geographica Regional Studies on Development Volume 20 Issue 2 Page 25. | ISSN:0867-6046,0,0,2,0,2,2,0,100,0,0,0,0,0
"getit.library.nyu.edu/resolve?genre=article&isbn=&issn=08838534&title=Journal of Multicultural Counseling & Development=&volume=14&issue=&date=19860401&atitle=Dating patterns of black students on white southern campuses.&aulast=Clark, Maxine L.&spage=85&sid=EBSCO:Education Full Text (H.W. Wilson)&pid=Clark, Maxine L.50821185419860401Education Full Text (H.W. Wilson)",Article | Dating patterns of black students on white southern campuses. | Clark Maxine L 1986 Apr 01 | Published in Journal Journal of Multicultural Counseling Volume 14 Page 85. | ISSN:0883-8534,0,0,1,0,1,1,0,100,0,0,0,0,0
getit.library.nyu.edu/resolve?genre=article&isbn=&issn=08849153&title=Journal of Student Financial Aid&volume=&issue=&date=&atitle=&aulast=&spage=&sid=EBSCO:Education Source Publications&pid=Education Source Publications,Article | Journal of Student Financial Aid |  | ISSN:0884-9153 | undefined,0,0,2,0,2,2,0,100,0,0,0,0,0
"getit.library.nyu.edu/resolve?genre=article&isbn=&issn=08852006&title=Early Childhood Research Quarterly&volume=58&issue=&date=20220101&atitle=Standards, curriculum, and assessment in early childhood education: Examining alignment across multiple state systems&aulast=Whitaker, Anamarie A&spage=59&sid=EBSCO:ScienceDirect&pid=Whitaker, Anamarie AS088520062100092220220101ScienceDirect",Article | Standards curriculum and assessment in early childhood education Examining alignment across multiple state systems | Whitaker Anamarie A 2022 Jan 01 | Published in Journal Early Childhood Research Quarterly Volume 58 Page 59. | ISSN:0885-2006,1,0,0,1,1,2,50,50,0,0,0,0,0
"getit.library.nyu.edu/resolve?genre=article&isbn=&issn=08860394&title=The Family Life Coordinator&volume=12&issue=3/4&date=19630701&atitle=Attitudes toward Interracial Dating&aulast=Barnett, Larry D.&spage=88&sid=EBSCO:JSTOR Journals&pid=Barnett, Larry D.edsjsr.10.2307.58146419630701JSTOR Journals",Article | Attitudes toward Interracial Dating | Barnett Larry D 1963 Jul 01 | Published in Journal The Family Life Coordinator Volume 12 Issue 3/4 Page 88. | ISSN:0886-0394,1,0,0,1,1,2,50,50,0,0,0,0,0
"getit.library.nyu.edu/resolve?genre=article&isbn=&issn=08862605&title=JOURNAL OF INTERPERSONAL VIOLENCE&volume=&issue=&date=20211223&atitle=Will You Protect Me or Make the Situation Worse?: Teachers' Responses to School Violence Against Students With Disabilities&aulast=Njelesani, Janet&spage=&sid=EBSCO:Social Sciences Citation Index&pid=Njelesani, Janet00073766270000120211223Social Sciences Citation Index",Article | Will You Protect Me or Make the Situation Worse Teachers Responses to School Violence Against Students With Disabilities | Njelesani Janet 2021 Dec 23 | Published in Journal JOURNAL OF INTERPERSONAL VIOLENCE. | ISSN:0886-2605,2,0,0,2,2,4,50,50,0,0,0,0,0
"getit.library.nyu.edu/resolve?genre=article&isbn=&issn=08862605&title=Journal of Interpersonal Violence&volume=14&issue=9&date=19990101&atitle=The relationship of animal abuse to violence and other forms of antisocial behavior&aulast=Arluke, A.&spage=963&sid=EBSCO:Scopus\u00ae&pid=Arluke, A.edselc.2-52.0-003319608419990101Scopus\u00ae",Article | The relationship of animal abuse to violence and other forms of antisocial behavior | Arluke A 1999 Jan 01 | Published in Journal Journal of Interpersonal Violence Volume 14 Issue 9 Page 963. | ISSN:0886-2605,1,0,0,1,1,2,50,50,0,0,0,0,0
"getit.library.nyu.edu/resolve?genre=article&isbn=&issn=08862605&title=Journal of Interpersonal Violence&volume=37&issue=7/8&date=20220401&atitle=Childhood Sexual Abuse and Coping as Young Adults: The Roles of Attachment and Mattering.&aulast=Love, Sarah&spage=NP4931&sid=EBSCO:Complementary Index&pid=Love, Sarah15612338420220401Complementary Index",Article | Childhood Sexual Abuse and Coping as Young Adults The Roles of Attachment and Mattering. | Love Sarah 2022 Apr 01 | Published in Journal Journal of Interpersonal Violence Volume 37 Issue 7/8 Page NP4931. | ISSN:0886-2605,2,0,0,2,2,4,50,50,0,0,0,0,0
"getit.library.nyu.edu/resolve?genre=article&isbn=&issn=08884064&title=Teacher Education & Special Education=&volume=31&issue=2&date=20080401&atitle=Effective Teacher Training at the Autism Institute in the People's Republic of China.&aulast=McCabe, Helen&spage=103&sid=EBSCO:Education Source&pid=McCabe, Helen50805809420080401Education Source",Article | Effective Teacher Training at the Autism Institute in the People's Republic of China. | McCabe Helen 2008 Apr 01 | Published in Journal Teacher Education Volume 31 Issue 2 Page 103. | ISSN:0888-4064,2,0,0,2,2,4,50,50,0,0,0,0,0
"getit.library.nyu.edu/resolve?genre=article&isbn=&issn=0889048X&title=Agriculture & Human Values=&volume=37&issue=4&date=20201201&atitle=Priming the pump of impact entrepreneurship and social finance in China.&aulast=Jia, Xiangping&spage=1293&sid=EBSCO:Complementary Index&pid=Jia, Xiangping14685402020201201Complementary Index",Article | Priming the pump of impact entrepreneurship and social finance in China. | Jia Xiangping 2020 Dec 01 | Published in Journal Agriculture Volume 37 Issue 4 Page 1293. | ISSN:0889-048X,5,0,0,5,5,10,50,50,0,0,0,0,0
"getit.library.nyu.edu/resolve?genre=article&isbn=&issn=08893268&title=Journal of Business & Psychology=&volume=14&issue=4&date=20000715&atitle=Another side to downsizing: survivors' behavior and self-affirmation.&aulast=Parker, Gerald E.&spage=593&sid=EBSCO:Business Abstracts with Full Text (H.W. Wilson)&pid=Parker, Gerald E.51011099320000715Business Abstracts with Full Text (H.W. Wilson)",Article | Another side to downsizing survivors behavior and self-affirmation. | Parker Gerald E 2000 Jul 15 | Published in Journal Journal of Business Volume 14 Issue 4 Page 593. | ISSN:0889-3268,0,0,4,0,4,4,0,100,0,0,0,0,0
"getit.library.nyu.edu/resolve?genre=article&isbn=&issn=08908567&title=Journal of the American Academy of Child & Adolescent Psychiatry=&volume=43&issue=6&date=20040601&atitle=An Efficacy/Effectiveness Study of Cognitive-Behavioral Treatment for Adolescents With Comorbid Major Depression and Conduct Disorder&aulast=Rohde, Paul&spage=660&sid=EBSCO:ScienceDirect&pid=Rohde, PaulS089085670961315020040601ScienceDirect",Article | An Efficacy/Effectiveness Study of Cognitive-Behavioral Treatment for Adolescents With Comorbid Major Depression and Conduct Disorder | Rohde Paul 2004 Jun 01 | Published in Journal Journal of the American Academy of Child Volume 43 Issue 6 Page 660. | ISSN:0890-8567,2,0,0,2,2,4,50,50,0,0,0,0,0
"getit.library.nyu.edu/resolve?genre=article&isbn=&issn=08926794&title=Ethics & International Affairs=&volume=33&issue=2&date=20190601&atitle=The Future Impact of Artificial Intelligence on Humans and Human Rights.&aulast=Livingston, Steven&spage=141&sid=EBSCO:Social Sciences Full Text (H.W. Wilson)&pid=Livingston, Steven13684469120190601Social Sciences Full Text (H.W. Wilson)",Article | The Future Impact of Artificial Intelligence on Humans and Human Rights. | Livingston Steven 2019 Jun 01 | Published in Journal Ethics Volume 33 Issue 2 Page 141. | ISSN:0892-6794,3,0,0,3,3,6,50,50,0,0,0,0,0
"getit.library.nyu.edu/resolve?genre=article&isbn=&issn=08933952&title=Modern Pathology&volume=&issue=Preprints&date=20220101&atitle=Characterization of initial/early histologic features of proliferative leukoplakia and correlation with malignant transformation: a multicenter study&aulast=Alabdulaaly, Lama&spage=1&sid=EBSCO:Supplemental Index&pid=Alabdulaaly, Lamaejs5896697620220101Supplemental Index",Article | Characterization of initial/early histologic features of proliferative leukoplakia and correlation with malignant transformation a multicenter study | Alabdulaaly Lama 2022 Jan 01 | Published in Journal Modern Pathology Issue Preprints Page 1. | ISSN:0893-3952,4,0,0,4,4,8,50,50,0,0,0,0,0
"getit.library.nyu.edu/resolve?genre=article&isbn=&issn=08938849&title=Journal of the World Aquaculture Society&volume=53&issue=1&date=20220201&atitle=Connecting polarized light and water turbidity with feeding rates in Octopus americanus paralarvae.&aulast=Gavioli, Ivan Luiz&spage=241&sid=EBSCO:Environment Complete&pid=Gavioli, Ivan Luiz15510627820220201Environment Complete",Article | Connecting polarized light and water turbidity with feeding rates in Octopus americanus paralarvae. | Gavioli Ivan Luiz 2022 Feb 01 | Published in Journal Journal of the World Aquaculture Society Volume 53 Issue 1 Page 241. | ISSN:0893-8849,3,0,0,3,3,6,50,50,0,0,0,0,0
"getit.library.nyu.edu/resolve?genre=article&isbn=&issn=08941130&title=JOURNAL OF HAND THERAPY&volume=25&issue=2&date=20120101&atitle=Edema: A Silent but Important Factor&aulast=Villeco, J. P.&spage=153&sid=EBSCO:British Library Document Supply Centre Inside Serials & Conference Proceedings=&pid=Villeco, J. P.RN31040748220120101British Library Document Supply Centre Inside Serials & Conference Proceedings=",Article | Edema A Silent but Important Factor | Villeco J P 2012 Jan 01 | Published in Journal JOURNAL OF HAND THERAPY Volume 25 Issue 2 Page 153. | ISSN:0894-1130,0,0,3,0,3,3,0,100,0,0,0,0,0
"getit.library.nyu.edu/resolve?genre=article&isbn=&issn=08949832&title=Genders&volume=2&issue=2&date=20160101&atitle=Racialized Disgender and Disruptive Futurity in Lorde\u2019s and Engelberg\u2019s Cancer Narratives&aulast=Obourn, Milo&spage=&sid=EBSCO:MLA International Bibliography&pid=Obourn, Milo201839566320160101MLA International Bibliography",Article | Racialized Disgender and Disruptive Futurity in Lorde\u2019s and Engelberg\u2019s Cancer Narratives | Obourn Milo 2016 Jan 01 | Published in Journal Genders Volume 2 Issue 2. | ISSN:1936-3249,1,0,0,1,1,2,50,50,0,0,0,0,0
"getit.library.nyu.edu/resolve?genre=article&isbn=&issn=09161503&title=Research in Social Psychology&volume=24&issue=3&date=20080101&atitle=The psychological recovery process from loss&aulast=Ikeuchi, H.&spage=169&sid=EBSCO:Scopus\u00ae&pid=Ikeuchi, H.edselc.2-52.0-7814938440920080101Scopus\u00ae",Article | The psychological recovery process from loss | Ikeuchi H 2008 Jan 01 | Published in Journal Research in Social Psychology Volume 24 Issue 3 Page 169. | ISSN:0916-1503,0,1,1,1,1,2,50,50,0,0,0,0,0
"getit.library.nyu.edu/resolve?genre=article&isbn=&issn=09252312&title=Neurocomputing&volume=425&issue=&date=20210215&atitle=A Two-stage Chinese text summarization algorithm using keyword information and adversarial learning&aulast=Deng, Zhenrong&spage=117&sid=EBSCO:ScienceDirect&pid=Deng, ZhenrongS092523122030316720210215ScienceDirect",Article | A Two-stage Chinese text summarization algorithm using keyword information and adversarial learning | Deng Zhenrong 2021 Feb 15 | Published in Journal Neurocomputing Volume 425 Page 117. | ISSN:0925-2312,1,0,0,1,1,2,50,50,0,0,0,0,0
"getit.library.nyu.edu/resolve?genre=article&isbn=&issn=09394451&title=Amino Acids&volume=52&issue=2&date=20200201&atitle=Branched-chain polyamine stabilizes RNA polymerase at elevated temperatures in hyperthermophiles.&aulast=Yamori, Yuka&spage=275&sid=EBSCO:Complementary Index&pid=Yamori, Yuka14191694820200201Complementary Index",Article | Branched-chain polyamine stabilizes RNA polymerase at elevated temperatures in hyperthermophiles. | Yamori Yuka 2020 Feb 01 | Published in Journal Amino Acids Volume 52 Issue 2 Page 275. | ISSN:0939-4451,2,0,0,2,2,4,50,50,0,0,0,0,0
"getit.library.nyu.edu/resolve?genre=article&isbn=&issn=09441344&title=ENVIRONMENTAL SCIENCE AND POLLUTION RESEARCH&volume=28&issue=44&date=20211101&atitle=Role of education in poverty reduction: macroeconomic and social determinants form developing economies&aulast=Liu, Fengqin&spage=63163&sid=EBSCO:Social Sciences Citation Index&pid=Liu, Fengqin00066977310000420211101Social Sciences Citation Index",Article | Role of education in poverty reduction macroeconomic and social determinants form developing economies | Liu Fengqin 2021 Nov 01 | Published in Journal ENVIRONMENTAL SCIENCE AND POLLUTION RESEARCH Volume 28 Issue 44 Page 63163. | ISSN:0944-1344,4,0,0,4,4,8,50,50,0,0,0,0,0
"getit.library.nyu.edu/resolve?genre=article&isbn=&issn=09517367&title=Current opinion in psychiatry&volume=34&issue=4&date=20210101&atitle=Early childhood trauma, substance use and complex concurrent disorders among adolescents&aulast=Cabanis, Maurice&spage=393&sid=EBSCO:British Library Document Supply Centre Inside Serials & Conference Proceedings=&pid=Cabanis, Mauricevdc.100121686634.0x00000120210101British Library Document Supply Centre Inside Serials & Conference Proceedings=",Article | Early childhood trauma substance use and complex concurrent disorders among adolescents | Cabanis Maurice 2021 Jan 01 | Published in Journal Current opinion in psychiatry Volume 34 Issue 4 Page 393. | ISSN:0951-7367,2,0,0,2,2,4,50,50,0,0,0,0,0
"getit.library.nyu.edu/resolve?genre=article&isbn=&issn=09517375&title=Current Opinion in Infectious Diseases&volume=34&issue=1&date=20210201&atitle=Effects of HIV voluntary medical male circumcision programs on sexually transmitted infections.&aulast=Matoga, Mitch&spage=50&sid=EBSCO:CINAHL Complete&pid=Matoga, Mitch14832922120210201CINAHL Complete",Article | Effects of HIV voluntary medical male circumcision programs on sexually transmitted infections. | Matoga Mitch 2021 Feb 01 | Published in Journal Current Opinion in Infectious Diseases Volume 34 Issue 1 Page 50. | ISSN:0951-7375,0,0,2,0,2,2,0,100,0,0,0,0,0
"getit.library.nyu.edu/resolve?genre=article&isbn=&issn=09542361&title=New Statesman & Society=&volume=9&issue=&date=19960607&atitle=Striking home.&aulast=Bywater, Michael&spage=33&sid=EBSCO:Social Sciences Full Text (H.W. Wilson)&pid=Bywater, Michael51041412819960607Social Sciences Full Text (H.W. Wilson)",Article | Striking home. | Bywater Michael 1996 Jun 07 | Published in Journal New Statesman Volume 9 Page 33. | ISSN:0954-2361,0,0,2,0,2,2,0,100,0,0,0,0,0
getit.library.nyu.edu/resolve?genre=article&isbn=&issn=0955534X&title=European Business Review&volume=33&issue=2&date=20200110&atitle=Beyond the \u201clike\u201d: customer engagement of brand fans on Facebook&aulast=Tania Maree&spage=255&sid=EBSCO:Emerald Insight&pid=Tania Mareeedsemr.10.1108.EBR.02.2019.002520200110Emerald Insight,Article | Beyond the u201clike\u201d customer engagement of brand fans on Facebook | Tania Maree 2020 Jan 10 | Published in Journal European Business Review Volume 33 Issue 2 Page 255. | ISSN:0955-534X,0,0,2,0,2,2,0,100,0,0,0,0,0
"getit.library.nyu.edu/resolve?genre=article&isbn=&issn=09565221&title=SCANDINAVIAN JOURNAL OF MANAGEMENT&volume=37&issue=3&date=20210901&atitle=Getting the timing right: Kairos as the rhetorical framing of time&aulast=Lantz, Prins Marcus Valiant&spage=&sid=EBSCO:Social Sciences Citation Index&pid=Lantz, Prins Marcus Valiant00069679910000620210901Social Sciences Citation Index",Article | Getting the timing right Kairos as the rhetorical framing of time | Lantz Prins Marcus Valiant 2021 Sep 01 | Published in Journal SCANDINAVIAN JOURNAL OF MANAGEMENT Volume 37 Issue 3. | ISSN:0956-5221,1,0,0,1,1,2,50,50,0,0,0,0,0
"getit.library.nyu.edu/resolve?genre=article&isbn=&issn=0959437X&title=Current Opinion in Genetics and Development&volume=4&issue=1&date=19940101&atitle=The hetero-oligomeric antigen receptor complex and its coupling to cytoplasmic effectors&aulast=Cambier, J.C.&spage=55&sid=EBSCO:Scopus\u00ae&pid=Cambier, J.C.edselc.2-52.0-002795259219940101Scopus\u00ae",Article | The hetero-oligomeric antigen receptor complex and its coupling to cytoplasmic effectors | Cambier J C 1994 Jan 01 | Published in Journal Current Opinion in Genetics and Development Volume 4 Issue 1 Page 55. | ISSN:0959-437X,1,0,0,1,1,2,50,50,0,0,0,0,0
"getit.library.nyu.edu/resolve?genre=article&isbn=&issn=09612025&title=Women's History Review&volume=30&issue=4&date=20210701&atitle=A poor woman's lawyer? Feminism, the labour movement, and working-class women's access to the law in England, 1890\u20131935.&aulast=Bradley, Kate&spage=632&sid=EBSCO:Complementary Index&pid=Bradley, Kate15113673520210701Complementary Index",Article | A poor woman's lawyer Feminism the labour movement and working-class women's access to the law in England 1890\u20131935. | Bradley Kate 2021 Jul 01 | Published in Journal Women's History Review Volume 30 Issue 4 Page 632. | ISSN:0961-2025,2,0,0,2,2,4,50,50,0,0,0,0,0
getit.library.nyu.edu/resolve?genre=article&isbn=&issn=09670734&title=Human Resource Management International Digest&volume=30&issue=3&date=20220404&atitle=Seeking truth about the road ahead within reviews on Glassdoor : A window into cultural satisfaction and employee referral intention dynamics&aulast=&spage=46&sid=EBSCO:Emerald Insight&pid=edsemr.10.1108.HRMID.03.2022.003920220404Emerald Insight,Article | Seeking truth about the road ahead within reviews on Glassdoor A window into cultural satisfaction and employee referral intention dynamics | 2022 Apr 04 | Published in Journal Human Resource Management International Digest Volume 30 Issue 3 Page 46. | ISSN:0967-0734,0,0,1,0,1,1,0,100,0,0,0,0,0
"getit.library.nyu.edu/resolve?genre=article&isbn=&issn=09687599&title=Disability & Society=&volume=2&issue=2&date=20080301&atitle=Exploring Internalized Ableism Using Critical Race Theory&aulast=Campbell, Fiona A. Kumari&spage=151&sid=EBSCO:MLA International Bibliography&pid=Campbell, Fiona A. Kumari200830137620080301MLA International Bibliography",Article | Exploring Internalized Ableism Using Critical Race Theory | Campbell Fiona A Kumari 2008 Mar 01 | Published in Journal Disability Volume 2 Issue 2 Page 151. | ISSN:0968-7599,1,0,0,1,1,2,50,50,0,0,0,0,0
getit.library.nyu.edu/resolve?genre=article&isbn=&issn=1000419X&title=\u4e2d\u5b66\u8bed\u6587&volume=&issue=26&date=20210101&atitle=\u865a\u5b9e\u76f8\u751f:\u7406\u60f3\u793e\u4f1a\u548c\u4eba\u6027\u7684\u61a7\u61ac--\u300a\u6843\u82b1\u6e90\u8bb0\u300b\u4e00\u6587\u6559\u5b66\u8bbe\u8ba1(\u7b2c\u4e8c\u8bfe\u65f6)&aulast=\u4ee3\u4e91\u971e;\u6c72\u5b89\u5e86&spage=42&sid=EBSCO:China Science & Technology Journal Database=&pid=\u4ee3\u4e91\u971e;\u6c72\u5b89\u5e86edscqv.710565445620210101China Science & Technology Journal Database=,Article | \u865a\u5b9e\u76f8\u751f u7406\u60f3\u793e\u4f1a\u548c\u4eba\u6027\u7684\u61a7\u61ac u300a\u6843\u82b1\u6e90\u8bb0\u300b\u4e00\u6587\u6559\u5b66\u8bbe\u8ba1 u7b2c\u4e8c\u8bfe\u65f6) | \u4ee3\u4e91\u971e 2021 Jan 01 | Published in Journal u4e2d\u5b66\u8bed\u6587 Issue 26 Page 42. | ISSN:1000-419X,1,0,0,1,1,2,50,50,0,0,0,0,0
getit.library.nyu.edu/resolve?genre=article&isbn=&issn=10005102&title=\u9752\u6d77\u5e2b\u7bc4\u5927\u5b78\u5b78\u5831\uff08\u54f2\u5b78\u793e\u6703\u79d1\u5b78\u7248\uff09 / Journal of Qingai Normal University (Philosophy and Social Sciences Edition)&volume=&issue=1&date=20110130&atitle=\u6c11\u7cb9\u8bdd\u8bed\u4e0e\u4e2d\u56fd\u5de6\u7ffc\u77e5\u8bc6\u5206\u5b50\u6587\u5316\u6027\u683c\u7684\u5851\u9020 / Populism Discourse and the Molding of the Cultural Character of Chinese Left Wing Intellectuals&aulast=\u5218\u6653\u6797 / Xiao-Lin Liu&spage=89&sid=EBSCO:Airiti Library eBooks & Journals - \u83ef\u85dd\u7dda\u4e0a\u5716\u66f8\u9928=&pid=\u5218\u6653\u6797 / Xiao-Lin Liuedsarl.10005102.201101.201107110145.201107110145.89.9320110130Airiti Library eBooks & Journals - \u83ef\u85dd\u7dda\u4e0a\u5716\u66f8\u9928=,Article | \u6c11\u7cb9\u8bdd\u8bed\u4e0e\u4e2d\u56fd\u5de6\u7ffc\u77e5\u8bc6\u5206\u5b50\u6587\u5316\u6027\u683c\u7684\u5851\u9020 Populism Discourse and the Molding of the Cultural Character of Chinese Left Wing Intellectuals | \u5218\u6653\u6797 Xiao-Lin Liu 2011 Jan 30 | Published in Journal u9752\u6d77\u5e2b\u7bc4\u5927\u5b78\u5b78\u5831\uff08\u54f2\u5b78\u793e\u6703\u79d1\u5b78\u7248\uff09 Journal of Qingai Normal University Philosophy and Social Sciences Edition Issue 1 Page 89. | ISSN:1000-5102,1,0,0,1,1,2,50,50,0,0,0,0,0
getit.library.nyu.edu/resolve?genre=article&isbn=&issn=10032592&title=\u7f8e\u4e0e\u65f6\u4ee3:\u7f8e\u5b66(\u4e0b) / Aesthetics&volume=&issue=7&date=20210101&atitle=\u5973\u6027\u7684\u529b\u91cf\u2014\u2014\u4ee5\u4e01\u73b2\u300a\u6211\u5728\u971e\u6751\u7684\u65f6\u5019\u300b\u4e2d\u7684\u8d1e\u8d1e\u4e3a\u4f8b&aulast=\u5173\u5a67\u8fb0&spage=104&sid=EBSCO:China Science & Technology Journal Database=&pid=\u5173\u5a67\u8fb0edscqv.710529058120210101China Science & Technology Journal Database=,Article | \u5973\u6027\u7684\u529b\u91cf\u2014\u2014\u4ee5\u4e01\u73b2\u300a\u6211\u5728\u971e\u6751\u7684\u65f6\u5019\u300b\u4e2d\u7684\u8d1e\u8d1e\u4e3a\u4f8b | \u5173\u5a67\u8fb0 2021 Jan 01 | Published in Journal u7f8e\u4e0e\u65f6\u4ee3 u7f8e\u5b66 u4e0b Aesthetics Issue 7 Page 104. | ISSN:1003-2592,0,0,4,0,4,4,0,100,0,0,0,0,0
getit.library.nyu.edu/resolve?genre=article&isbn=&issn=10039104&title=\u827a\u672f\u767e\u5bb6 / Hundred Schools In Arts&volume=36&issue=3&date=20200101&atitle=\u4e2d\u56fd\u7985\u5b97\u7f8e\u5b66\u7684\u5ba1\u7f8e\u610f\u5883\u4e0e\u751f\u6001\u7cbe\u795e&aulast=\u5f6d\u4fee\u94f6;\u59da\u7fbf&spage=17&sid=EBSCO:China Science & Technology Journal Database=&pid=\u5f6d\u4fee\u94f6;\u59da\u7fbfedscqv.710272738920200101China Science & Technology Journal Database=,Article | \u4e2d\u56fd\u7985\u5b97\u7f8e\u5b66\u7684\u5ba1\u7f8e\u610f\u5883\u4e0e\u751f\u6001\u7cbe\u795e | \u5f6d\u4fee\u94f6 2020 Jan 01 | Published in Journal u827a\u672f\u767e\u5bb6 Hundred Schools In Arts Volume 36 Issue 3 Page 17. | ISSN:1003-9104,0,0,1,0,1,1,0,100,0,0,0,0,0
getit.library.nyu.edu/resolve?genre=article&isbn=&issn=10048804&title=\u793e\u4f1a / Society&volume=&issue=3&date=20150101&atitle=\u6027\u522b\u64cd\u6f14\u7406\u8bba\u7684\u7ecf\u9a8c\u89e3\u91ca\u4e0e\u5973\u6027\u4e3b\u4e49\u65b9\u6cd5\u8bba\u53cd\u601d\u4ee5\u9ad8\u5c42\u4e24\u6027\u4eba\u624d\u8bbf\u8c08\u4e3a\u4f8b / Empirical Explanation of Gender Performance Theory and Reflection upon Feminism Methodology\uff1aBasing on Interviews of Upscale Elites&aulast=\u9ad8\u7b11\u6960&spage=121&sid=EBSCO:China Online Journals (Wanfang)&pid=\u9ad8\u7b11\u6960edscoj.sheh20150300520150101China Online Journals (Wanfang),Article | \u6027\u522b\u64cd\u6f14\u7406\u8bba\u7684\u7ecf\u9a8c\u89e3\u91ca\u4e0e\u5973\u6027\u4e3b\u4e49\u65b9\u6cd5\u8bba\u53cd\u601d\u4ee5\u9ad8\u5c42\u4e24\u6027\u4eba\u624d\u8bbf\u8c08\u4e3a\u4f8b Empirical Explanation of Gender Performance Theory and Reflection upon Feminism Methodology\uff1aBasing on Interviews of Upscale Elites | \u9ad8\u7b11\u6960 2015 Jan 01 | Published in Journal u793e\u4f1a Society Issue 3 Page 121. | ISSN:1004-8804,3,0,0,3,3,6,50,50,0,0,0,0,0
getit.library.nyu.edu/resolve?genre=article&isbn=&issn=1005944X&title=\u4e2d\u56fd\u52a8\u7269\u68c0\u75ab / CHINA ANIMAL HEALTH INSPECTION&volume=36&issue=12&date=20190101&atitle=\u4e0a\u6d77\u5e02\u793e\u533a\u6d41\u6d6a\u732bTNR\u8bd5\u70b9\u5206\u6790 / Analysis on the Pilot Program of TNR for Stray Cats in an Urban Community in Shanghai City&aulast=\u8d75\u6d2a\u8fdb&spage=36&sid=EBSCO:China Online Journals (Wanfang)&pid=\u8d75\u6d2a\u8fdbedscoj.zgdwjy20191200820190101China Online Journals (Wanfang),Article | \u4e0a\u6d77\u5e02\u793e\u533a\u6d41\u6d6a\u732bTNR\u8bd5\u70b9\u5206\u6790 Analysis on the Pilot Program of TNR for Stray Cats in an Urban Community in Shanghai City | \u8d75\u6d2a\u8fdb 2019 Jan 01 | Published in Journal u4e2d\u56fd\u52a8\u7269\u68c0\u75ab CHINA ANIMAL HEALTH INSPECTION Volume 36 Issue 12 Page 36. | ISSN:1005-944X,1,0,0,1,1,2,50,50,0,0,0,0,0
getit.library.nyu.edu/resolve?genre=article&isbn=&issn=10083707&title=\u6d59\u6c5f\u5efa\u7b51 / ZheJiang Construction&volume=37&issue=3&date=20200101&atitle=\u6d77\u7ef5\u57ce\u5e02\u5efa\u8bbe\u5b9e\u8df5\u6027\u7b56\u7565\u7814\u7a76\u2014\u2014\u4ee5\u5357\u65b9\u591a\u96e8\u5730\u533a\u6df1\u5733\u5e02\u4e3a\u4f8b / Practical Strategy of Sponge City Construction :Take Shenzhen City as an Example in the Rainy Area of South China&aulast=\u9648\u6797&spage=9&sid=EBSCO:China Online Journals (Wanfang)&pid=\u9648\u6797edscoj.zjjz20200300320200101China Online Journals (Wanfang),Article | \u6d77\u7ef5\u57ce\u5e02\u5efa\u8bbe\u5b9e\u8df5\u6027\u7b56\u7565\u7814\u7a76\u2014\u2014\u4ee5\u5357\u65b9\u591a\u96e8\u5730\u533a\u6df1\u5733\u5e02\u4e3a\u4f8b Practical Strategy of Sponge City Construction Take Shenzhen City as an Example in the Rainy Area of South China | \u9648\u6797 2020 Jan 01 | Published in Journal u6d59\u6c5f\u5efa\u7b51 ZheJiang Construction Volume 37 Issue 3 Page 9. | ISSN:1008-3707,1,0,0,1,1,2,50,50,0,0,0,0,0
getit.library.nyu.edu/resolve?genre=article&isbn=&issn=10095039&title=\u6d77\u5916\u82f1\u8bed\uff08\u4e0a\uff09 / Overseas English&volume=&issue=4&date=20200101&atitle=Thematic Structure and the Realization of the Discourse Function of The Little Prince / Thematic Structure and the Realization of the Discourse Function of The Little Prince&aulast=\u738b\u9752&spage=252&sid=EBSCO:China Online Journals (Wanfang)&pid=\u738b\u9752edscoj.hwyy.z20200412120200101China Online Journals (Wanfang),Article | Thematic Structure and the Realization of the Discourse Function of The Little Prince Thematic Structure and the Realization of the Discourse Function of The Little Prince | \u738b\u9752 2020 Jan 01 | Published in Journal u6d77\u5916\u82f1\u8bed\uff08\u4e0a\uff09 Overseas English Issue 4 Page 252. | ISSN:1009-5039,1,0,0,1,1,2,50,50,0,0,0,0,0
getit.library.nyu.edu/resolve?genre=article&isbn=&issn=10109919&title=Old Testament Essays&volume=33&issue=3&date=20201201&atitle=Suffering in the Epic of Gilgamesh Epic&aulast=Gerda De Villiers&spage=&sid=EBSCO:Directory of Open Access Journals&pid=Gerda De Villiersedsdoj.0ba4246668df455b93781c8d9a7191a720201201Directory of Open Access Journals,Article | Suffering in the Epic of Gilgamesh Epic | Gerda De Villiers 2020 Dec 01 | Published in Journal Old Testament Essays Volume 33 Issue 3. | ISSN:1010-9919,0,0,2,0,2,2,0,100,0,0,0,0,0
"getit.library.nyu.edu/resolve?genre=article&isbn=&issn=10184813&title=European Journal of Human Genetics&volume=5&issue=6&date=19970101&atitle=Refined mapping of a gene for autosomal dominant progressive sensorineural hearing loss (DFNA5) to a 2-cM region, and exclusion of a candidate gene that is expressed in the cochlea&aulast=Van Laer, L.&spage=397&sid=EBSCO:Scopus\u00ae&pid=Van Laer, L.edselc.2-52.0-1314425774319970101Scopus\u00ae",Article | Refined mapping of a gene for autosomal dominant progressive sensorineural hearing loss DFNA5 to a 2-cM region and exclusion of a candidate gene that is expressed in the cochlea | Van Laer L 1997 Jan 01 | Published in Journal European Journal of Human Genetics Volume 5 Issue 6 Page 397. | ISSN:1018-4813,2,0,0,2,2,4,50,50,0,0,0,0,0
getit.library.nyu.edu/resolve?genre=article&isbn=&issn=10207074&title=WIPO magazine&volume=4&issue=&date=20190101&atitle=Curbing cultural appropriation in the fashion industry with intellectual property&aulast=&spage=9&sid=EBSCO:British Library Document Supply Centre Inside Serials & Conference Proceedings=&pid=RN62147686420190101British Library Document Supply Centre Inside Serials & Conference Proceedings=,Article | Curbing cultural appropriation in the fashion industry with intellectual property | 2019 Jan 01 | Published in Journal WIPO magazine Volume 4 Page 9. | ISSN:1020-7074,0,0,1,0,1,1,0,100,0,0,0,0,0
"getit.library.nyu.edu/resolve?genre=article&isbn=&issn=10410236&title=HEALTH COMMUNICATION&volume=&issue=&date=20201219&atitle=The Influence of Pop Songs Referencing Anxiety, Depression, and Suicidal Ideation on College Students' Mental Health Empathy, Stigma, and Behavioral Intentions&aulast=Kresovich, Alex&spage=&sid=EBSCO:Social Sciences Citation Index&pid=Kresovich, Alex00059966780000120201219Social Sciences Citation Index",Article | The Influence of Pop Songs Referencing Anxiety Depression and Suicidal Ideation on College Students Mental Health Empathy Stigma and Behavioral Intentions | Kresovich Alex 2020 Dec 19 | Published in Journal HEALTH COMMUNICATION. | ISSN:1041-0236,2,0,0,2,2,4,50,50,0,0,0,0,0
"getit.library.nyu.edu/resolve?genre=article&isbn=&issn=10428232&title=Journal of progressive human services&volume=28&issue=2&date=20170101&atitle=Undoing Islamophobia: Awareness of Orientalism in Social Work&aulast=Beck, Elizabeth&spage=58&sid=EBSCO:British Library Document Supply Centre Inside Serials & Conference Proceedings=&pid=Beck, Elizabethvdc.100048563512.0x00000120170101British Library Document Supply Centre Inside Serials & Conference Proceedings=",Article | Undoing Islamophobia Awareness of Orientalism in Social Work | Beck Elizabeth 2017 Jan 01 | Published in Journal Journal of progressive human services Volume 28 Issue 2 Page 58. | ISSN:1042-8232,1,0,0,1,1,2,50,50,0,0,0,0,0
"getit.library.nyu.edu/resolve?genre=article&isbn=&issn=10439366&title=Yale Journal of Law and Feminism&volume=23&issue=1&date=20110101&atitle=Bad Girls of Art and Law: Abjection, Power, and Sexuality Exceptionalism in (Kara Walker's) Art and (Janet Halley's) Law&aulast=Davis, Adrienne D.&spage=1&sid=EBSCO:HeinOnline&pid=Davis, Adrienne D.edshol.hein.journals.yjfem23.420110101HeinOnline",Article | Bad Girls of Art and Law Abjection Power and Sexuality Exceptionalism in Kara Walker's Art and Janet Halley's Law | Davis Adrienne D 2011 Jan 01 | Published in Journal Yale Journal of Law and Feminism Volume 23 Issue 1 Page 1. | ISSN:1043-9366,4,0,0,4,4,8,50,50,0,0,0,0,0
"getit.library.nyu.edu/resolve?genre=article&isbn=&issn=10442073&title=Journal of Disability Policy Studies&volume=32&issue=2&date=20210901&atitle=Is Special Education Improving? Case Evidence From New York City.&aulast=Stiefel, Leanna&spage=95&sid=EBSCO:Professional Development Collection&pid=Stiefel, Leanna15187996120210901Professional Development Collection",Article | Is Special Education Improving Case Evidence From New York City. | Stiefel Leanna 2021 Sep 01 | Published in Journal Journal of Disability Policy Studies Volume 32 Issue 2 Page 95. | ISSN:1044-2073,1,0,0,1,1,2,50,50,0,0,0,0,0
getit.library.nyu.edu/resolve?genre=article&isbn=&issn=10467890&title=The Journal of clinical ethics&volume=26&issue=4&date=20151201&atitle=\,Article | \ | 2015 Dec 01 | Published in Journal The Journal of clinical ethics Volume 26 Issue 4. | ISSN:1046-7890,0,0,1,0,1,1,0,100,0,0,0,0,0
"getit.library.nyu.edu/resolve?genre=article&isbn=&issn=10479651&title=PHYSICAL MEDICINE AND REHABILITATION CLINICS OF NORTH AMERICA&volume=22&issue=2&date=20110101&atitle=Positioning, Splinting, and Contracture Management&aulast=Dewey, W.S.&spage=229&sid=EBSCO:British Library Document Supply Centre Inside Serials & Conference Proceedings=&pid=Dewey, W.S.RN29393642920110101British Library Document Supply Centre Inside Serials & Conference Proceedings=",Article | Positioning Splinting and Contracture Management | Dewey W S 2011 Jan 01 | Published in Journal PHYSICAL MEDICINE AND REHABILITATION CLINICS OF NORTH AMERICA Volume 22 Issue 2 Page 229. | ISSN:1047-9651,0,0,1,0,1,1,0,100,0,0,0,0,0
"getit.library.nyu.edu/resolve?genre=article&isbn=&issn=10497315&title=Research on Social Work Practice&volume=31&issue=7&date=20211001&atitle=Effectiveness of School-Based Child Sexual Abuse Prevention Programs in China: A Meta-Analysis.&aulast=Zhang, Huiping&spage=693&sid=EBSCO:Education Full Text (H.W. Wilson)&pid=Zhang, Huiping15277064620211001Education Full Text (H.W. Wilson)",Article | Effectiveness of School-Based Child Sexual Abuse Prevention Programs in China A Meta-Analysis. | Zhang Huiping 2021 Oct 01 | Published in Journal Research on Social Work Practice Volume 31 Issue 7 Page 693. | ISSN:1049-7315,1,0,0,1,1,2,50,50,0,0,0,0,0
"getit.library.nyu.edu/resolve?genre=article&isbn=&issn=10511482&title=Housing Policy Debate&volume=11&issue=2&date=20000101&atitle=Searching for a \u201csound Negro policy\u201d: A racial agenda for the Housing Acts of 1949 and 1954&aulast=Hirsch, A.R.&spage=393&sid=EBSCO:Scopus\u00ae&pid=Hirsch, A.R.edselc.2-52.0-001225703420000101Scopus\u00ae",Article | Searching for a u201csound Negro policy\u201d A racial agenda for the Housing Acts of 1949 and 1954 | Hirsch A R 2000 Jan 01 | Published in Journal Housing Policy Debate Volume 11 Issue 2 Page 393. | ISSN:1051-1482,0,0,1,0,1,1,0,100,0,0,0,0,0
"getit.library.nyu.edu/resolve?genre=article&isbn=&issn=10521577&title=Harvard health letter&volume=34&issue=12&date=20091001&atitle=Game on. Violent and possibly addictive, video games have become a major part of American childhood. What should parents do?&aulast=&spage=4&sid=EBSCO:MEDLINE with Full Text&pid=1992738620091001MEDLINE with Full Text",Article | Game on Violent and possibly addictive video games have become a major part of American childhood What should parents do? | 2009 Oct 01 | Published in Journal Harvard health letter Volume 34 Issue 12 Page 4. | ISSN:1052-1577,0,0,4,0,4,4,0,100,0,0,0,0,0
"getit.library.nyu.edu/resolve?genre=article&isbn=&issn=10538720&title=Journal of Gay and Lesbian Social Services&volume=19&issue=1&date=20070101&atitle=Can talking about oppression reduce depression? Modified CBT group treatment for LGBT people with depression&aulast=Ross, L.E.&spage=1&sid=EBSCO:Scopus\u00ae&pid=Ross, L.E.edselc.2-52.0-4264912170020070101Scopus\u00ae",Article | Can talking about oppression reduce depression Modified CBT group treatment for LGBT people with depression | Ross L E 2007 Jan 01 | Published in Journal Journal of Gay and Lesbian Social Services Volume 19 Issue 1 Page 1. | ISSN:1053-8720,2,0,0,2,2,4,50,50,0,0,0,0,0
"getit.library.nyu.edu/resolve?genre=article&isbn=&issn=10568190&title=Papers of the Regional Science Association&volume=69&issue=1&date=19901201&atitle=Screening for spatial dependence in regression analysis&aulast=Getis, A.&spage=69&sid=EBSCO:Scopus\u00ae&pid=Getis, A.edselc.2-52.0-000210920819901201Scopus\u00ae",Article | Screening for spatial dependence in regression analysis | Getis A 1990 Dec 01 | Published in Journal Papers of the Regional Science Association Volume 69 Issue 1 Page 69. | ISSN:1056-8190,1,0,0,1,1,2,50,50,0,0,0,0,0
"getit.library.nyu.edu/resolve?genre=article&isbn=&issn=10575219&title=International Review of Financial Analysis&volume=76&issue=&date=20210701&atitle=Trump vs. Paris: The impact of climate policy on U.S. listed oil and gas firm returns and volatility&aulast=Diaz-Rainey, Ivan&spage=&sid=EBSCO:ScienceDirect&pid=Diaz-Rainey, IvanS105752192100088020210701ScienceDirect",Article | Trump vs Paris The impact of climate policy on U.S listed oil and gas firm returns and volatility | Diaz Rainey Ivan 2021 Jul 01 | Published in Journal International Review of Financial Analysis Volume 76. | ISSN:1057-5219,0,0,1,0,1,1,0,100,0,0,0,0,0
"getit.library.nyu.edu/resolve?genre=article&isbn=&issn=1059440X&title=Asian Cinema&volume=8&issue=1&date=20120802&atitle=Zhang Yimou's Raise the Red Lantern: Contextual Analysis of Film Through a Confucian/Feminist Matrix&aulast=Lee, Joann&spage=120&sid=EBSCO:Supplemental Index&pid=Lee, Joannejs3396764120120802Supplemental Index",Article | Zhang Yimou's Raise the Red Lantern Contextual Analysis of Film Through a Confucian/Feminist Matrix | Lee Joann 2012 Aug 02 | Published in Journal Asian Cinema Volume 8 Issue 1 Page 120. | ISSN:1059-440X,0,0,1,0,1,1,0,100,0,0,0,0,0
"getit.library.nyu.edu/resolve?genre=article&isbn=&issn=10611932&title=Chinese Education & Society=&volume=47&issue=6&date=20141101&atitle=Graduate Employment in China: Current Trends and Issues.&aulast=Dian, Liu&spage=3&sid=EBSCO:Education Source&pid=Dian, Liu10270301120141101Education Source",Article | Graduate Employment in China Current Trends and Issues. | Dian Liu 2014 Nov 01 | Published in Journal Chinese Education Volume 47 Issue 6 Page 3. | ISSN:1061-1932,2,0,0,2,2,4,50,50,0,0,0,0,0
"getit.library.nyu.edu/resolve?genre=article&isbn=&issn=1065223X&title=Bulletin for Biblical Research&volume=20&issue=1&date=20100101&atitle=Identifying the 'angel of the Lord' in the book of Judges: a model for reconsidering the referent in other Old Testament loci&aulast=Lo\u0301pez, Rene\u0301&spage=1&sid=EBSCO:Atla Religion Database&pid=Lo\u0301pez, Rene\u0301ATLA000177935620100101Atla Religion Database",Article | Identifying the angel of the Lord in the book of Judges a model for reconsidering the referent in other Old Testament loci | Lou0301pez Reneu0301 2010 Jan 01 | Published in Journal Bulletin for Biblical Research Volume 20 Issue 1 Page 1. | ISSN:1065-223X,1,0,0,1,1,2,50,50,0,0,0,0,0
"getit.library.nyu.edu/resolve?genre=article&isbn=&issn=10685936&title=EAST BAY TIMES&volume=&issue=&date=20160914&atitle=Immigration reform--is this something we can ever achieve?&aulast=Burroughs, Franklin T.&spage=A10&sid=EBSCO:Chicano Database&pid=Burroughs, Franklin T.XCHD8096420160914Chicano Database",Article | Immigration reform is this something we can ever achieve? | Burroughs Franklin T 2016 Sep 14 | Published in Journal EAST BAY TIMES Page A10. | ISSN:1068-5936,2,1,1,3,3,6,50,50,0,0,0,0,0
"getit.library.nyu.edu/resolve?genre=article&isbn=&issn=10685936&title=EAST BAY TIMES&volume=&issue=&date=20180729&atitle='What was lost in the process was the family': 'zero tolerance' policy flawed from the beginning&aulast=Miroff, Nick&spage=A1&sid=EBSCO:Chicano Database&pid=Miroff, NickXCHD8204120180729Chicano Database",Article | 'What was lost in the process was the family zero tolerance policy flawed from the beginning | Miroff Nick 2018 Jul 29 | Published in Journal EAST BAY TIMES Page A1. | ISSN:1068-5936,2,1,1,3,3,6,50,50,0,0,0,0,0
"getit.library.nyu.edu/resolve?genre=article&isbn=&issn=1081549X&title=William & Mary Journal of Race, Gender =& Social Justice=&volume=27&issue=2&date=20210101&atitle=MARRIAGE MANDATES: COMPELLED DISCLOSURES OF RACE, SEX, AND GENDER DATA IN MARRIAGE LICENSING SCHEMES.&aulast=PHILLIPS, MIKAELA A.&spage=575&sid=EBSCO:Complementary Index&pid=PHILLIPS, MIKAELA A.15012759720210101Complementary Index",Article | MARRIAGE MANDATES COMPELLED DISCLOSURES OF RACE SEX AND GENDER DATA IN MARRIAGE LICENSING SCHEMES. | Phillips Mikaela A 2021 Jan 01 | Published in Journal William Volume 27 Issue 2 Page 575. | ISSN:1081-549X,3,0,0,3,3,6,50,50,0,0,0,0,0
getit.library.nyu.edu/resolve?genre=article&isbn=&issn=10816976&title=PoLAR: Political & Legal Anthropology Review=&volume=&issue=&date=&atitle=&aulast=&spage=&sid=EBSCO:Academic Search Complete -- Publications&pid=Academic Search Complete -- Publications,Article | PoLAR Political |  | ISSN:1081-6976 | undefined,0,0,5,0,5,5,0,100,0,0,0,0,0
getit.library.nyu.edu/resolve?genre=article&isbn=&issn=10895701&title=Reclaiming Children & Youth=&volume=&issue=&date=&atitle=&aulast=&spage=&sid=EBSCO:Education Source Publications&pid=Education Source Publications,Article | Reclaiming Children |  | ISSN:1089-5701 | undefined,0,0,3,0,3,3,0,100,0,0,0,0,0
"getit.library.nyu.edu/resolve?genre=article&isbn=&issn=10899472&title=Journal of PeriAnesthesia Nursing&volume=36&issue=3&date=20210601&atitle=Balancing Workload in the PACU by Using an Integrated OR Planning Methodology.&aulast=Debats, Charles E.J.M.&spage=279&sid=EBSCO:CINAHL Complete&pid=Debats, Charles E.J.M.15075022720210601CINAHL Complete",Article | Balancing Workload in the PACU by Using an Integrated OR Planning Methodology. | Debats Charles E.J.M 2021 Jun 01 | Published in Journal Journal of PeriAnesthesia Nursing Volume 36 Issue 3 Page 279. | ISSN:1089-9472,1,0,0,1,1,2,50,50,0,0,0,0,0
getit.library.nyu.edu/resolve?genre=article&isbn=&issn=10916458&title=Historical Geography&volume=&issue=&date=&atitle=&aulast=&spage=&sid=EBSCO:America: History and Life with Full Text -- Publications&pid=America: History and Life with Full Text -- Publications,Article | Historical Geography |  | ISSN:1091-6458 | undefined,0,0,4,0,4,4,0,100,0,0,0,0,0
getit.library.nyu.edu/resolve?genre=article&isbn=&issn=10916687&title=Logos: A Journal of Catholic Thought & Culture=&volume=&issue=&date=&atitle=&aulast=&spage=&sid=EBSCO:Humanities Source Publications&pid=Humanities Source Publications,Article | Logos A Journal of Catholic Thought |  | ISSN:1091-6687 | undefined,0,0,3,0,3,3,0,100,0,0,0,0,0
"getit.library.nyu.edu/resolve?genre=article&isbn=&issn=10942939&title=ANNUAL REVIEW OF POLITICAL SCIENCE, VOL 22&volume=22&issue=&date=20190101&atitle=The Origins and Consequences of Affective Polarization in the United States&aulast=Iyengar, Shanto&spage=129&sid=EBSCO:Social Sciences Citation Index&pid=Iyengar, Shanto00047572810000820190101Social Sciences Citation Index",Article | The Origins and Consequences of Affective Polarization in the United States | Iyengar Shanto 2019 Jan 01 | Published in Journal ANNUAL REVIEW OF POLITICAL SCIENCE VOL 22 Volume 22 Page 129. | ISSN:1094-2939,1,0,0,1,1,2,50,50,0,0,0,0,0
"getit.library.nyu.edu/resolve?genre=article&isbn=&issn=10983503&title=COLORLINES&volume=2&issue=4&date=19990101&atitle=Behind the power of 41 bullets: an interview with Ruth Wilson Gilmore&aulast=Gilmore, Ruth Wilson&spage=16&sid=EBSCO:Chicano Database&pid=Gilmore, Ruth WilsonXCHD6024519990101Chicano Database",Article | Behind the power of 41 bullets an interview with Ruth Wilson Gilmore | Gilmore Ruth Wilson 1999 Jan 01 | Published in Journal COLORLINES Volume 2 Issue 4 Page 16. | ISSN:1098-3503,3,2,1,5,4,9,56,44,0,0,0,0,0
getit.library.nyu.edu/resolve?genre=article&isbn=&issn=13210122&title=International Journal of Transpersonal Studies&volume=&issue=&date=&atitle=&aulast=&spage=&sid=EBSCO:Humanities Source Publications&pid=Humanities Source Publications,Article | International Journal of Transpersonal Studies |  | ISSN:1321-0122 | undefined,0,0,2,0,2,2,0,100,0,0,0,0,0
"getit.library.nyu.edu/resolve?genre=article&isbn=&issn=1331677X&title=Economic Research-Ekonomska Istrazivanja&volume=31&issue=1&date=20180101&atitle=Fashion effects: self-limitations of the free will caused by degeneration of the free market&aulast=Szocik, K.&spage=2100&sid=EBSCO:Scopus\u00ae&pid=Szocik, K.edselc.2-52.0-8506151345020180101Scopus\u00ae",Article | Fashion effects self-limitations of the free will caused by degeneration of the free market | Szocik K 2018 Jan 01 | Published in Journal Economic Research-Ekonomska Istrazivanja Volume 31 Issue 1 Page 2100. | ISSN:1331-677X,1,1,1,2,2,4,50,50,0,0,0,0,0
"getit.library.nyu.edu/resolve?genre=article&isbn=&issn=13867415&title=Theoretical Medicine & Bioethics=&volume=22&issue=1&date=20010101&atitle=The diving bell meets the butterfly: identity lost and re-membered.&aulast=Dudzinski, Denise&spage=33&sid=EBSCO:Complementary Index&pid=Dudzinski, Denise4994038420010101Complementary Index",Article | The diving bell meets the butterfly identity lost and re-membered. | Dudzinski Denise 2001 Jan 01 | Published in Journal Theoretical Medicine Volume 22 Issue 1 Page 33. | ISSN:1386-7415,0,0,2,0,2,2,0,100,0,0,0,0,0
"getit.library.nyu.edu/resolve?genre=article&isbn=&issn=14786567&title=KinoKultura&volume=21&issue=&date=20080701&atitle=Review of Aleksandr Kasatkin, dir., 'Listening to Silence' (Slushaia tishinu)&aulast=Timoshkina, Alissa&spage=&sid=EBSCO:American Bibliography of Slavic, East European, and Eurasian Studies&pid=Timoshkina, Alissa8744520080701American Bibliography of Slavic, East European, and Eurasian Studies",Article | Review of Aleksandr Kasatkin dir Listening to Silence Slushaia tishinu) | Timoshkina Alissa 2008 Jul 01 | Published in Journal KinoKultura Volume 21. | ISSN:1478-6567,1,0,0,1,1,2,50,50,0,0,0,0,0
"getit.library.nyu.edu/resolve?genre=article&isbn=&issn=14814374&title=CLCWeb: Comparative Literature & Culture: A WWWeb Journal=&volume=23&issue=1&date=20210301&atitle=Incipient Fascism: Black Radical Perspectives.&aulast=Toscano, Alberto&spage=1&sid=EBSCO:Complementary Index&pid=Toscano, Alberto15027512420210301Complementary Index",Article | Incipient Fascism Black Radical Perspectives. | Toscano Alberto 2021 Mar 01 | Published in Journal CLCWeb Comparative Literature Volume 23 Issue 1 Page 1. | ISSN:1481-4374,4,0,0,4,4,8,50,50,0,0,0,0,0
"getit.library.nyu.edu/resolve?genre=article&isbn=&issn=1536710X&title=JOURNAL OF SOCIAL WORK IN DISABILITY AND REHABILITATION&volume=9&issue=2/3&date=20100101&atitle=The Deaf Community and Culture at a Crossroads: Issues and Challenges&aulast=Pray, J.L.&spage=168&sid=EBSCO:British Library Document Supply Centre Inside Serials & Conference Proceedings=&pid=Pray, J.L.RN27937153620100101British Library Document Supply Centre Inside Serials & Conference Proceedings=",Article | The Deaf Community and Culture at a Crossroads Issues and Challenges | Pray J L 2010 Jan 01 | Published in Journal JOURNAL OF SOCIAL WORK IN DISABILITY AND REHABILITATION Volume 9 Issue 2/3 Page 168. | ISSN:1536-710X,0,0,1,0,1,1,0,100,0,0,0,0,0
"getit.library.nyu.edu/resolve?genre=article&isbn=&issn=16099982&title=Verbum et Ecclesia&volume=41&issue=1&date=20200101&atitle=The ethical and spiritual considerations of Matthew's Beatitudes: Configuration of the human being in companies&aulast=Vila Porras, Carolina&spage=1&sid=EBSCO:Atla Religion Database&pid=Vila Porras, CarolinaATLAiAZI21011100120420200101Atla Religion Database",Article | The ethical and spiritual considerations of Matthew's Beatitudes Configuration of the human being in companies | Vila Porras Carolina 2020 Jan 01 | Published in Journal Verbum et Ecclesia Volume 41 Issue 1 Page 1. | ISSN:1609-9982,3,1,1,4,4,8,50,50,0,0,0,0,0
getit.library.nyu.edu/resolve?genre=article&isbn=&issn=16641078&title=Frontiers in Psychology&volume=8&issue=&date=20171201&atitle=The Egosyntonic Nature of Anorexia: An Impediment to Recovery in Anorexia Nervosa Treatment&aulast=Eva C. Gregertsen&spage=&sid=EBSCO:Directory of Open Access Journals&pid=Eva C. Gregertsenedsdoj.552d94c1becc4a7da4e6d2c60ca8522620171201Directory of Open Access Journals,Article | The Egosyntonic Nature of Anorexia An Impediment to Recovery in Anorexia Nervosa Treatment | Eva C Gregertsen 2017 Dec 01 | Published in Journal Frontiers in Psychology Volume 8. | ISSN:1664-1078,0,0,2,0,2,2,0,100,0,0,0,0,0
getit.library.nyu.edu/resolve?genre=article&isbn=&issn=16745302&title=\u89e3\u653e\u519b\u827a\u672f\u5b66\u9662\u5b66\u62a5 / Journal of PLA Academy of Arts&volume=&issue=3&date=20130101&atitle=\u53f0\u6e7e\u95fd\u5357\u8bed\u6d41\u884c\u6b4c\u66f2\u300a\u7231\u62fc\u624d\u4f1a\u8d62\u300b\u4e4b\u5206\u6790&aulast=\u5362\u5e7f\u745e&spage=70&sid=EBSCO:China Online Journals (Wanfang)&pid=\u5362\u5e7f\u745eedscoj.jfjysxyxb20130301320130101China Online Journals (Wanfang),Article | \u53f0\u6e7e\u95fd\u5357\u8bed\u6d41\u884c\u6b4c\u66f2\u300a\u7231\u62fc\u624d\u4f1a\u8d62\u300b\u4e4b\u5206\u6790 | \u5362\u5e7f\u745e 2013 Jan 01 | Published in Journal u89e3\u653e\u519b\u827a\u672f\u5b66\u9662\u5b66\u62a5 Journal of PLA Academy of Arts Issue 3 Page 70. | ISSN:1674-5302,0,0,1,0,1,1,0,100,0,0,0,0,0
"getit.library.nyu.edu/resolve?genre=article&isbn=&issn=17418224&title=AI Practitioner&volume=23&issue=2&date=20210501&atitle=Strength-based Versus Deficit-based Action Learning for Developing Leaders, Teams, and Organizations in Asia: A Field Report of an Appreciative Inquiry and Action Learning Practitioner.&aulast=Tsui, Dorothy&spage=51&sid=EBSCO:CINAHL Complete&pid=Tsui, Dorothy15016063720210501CINAHL Complete",Article | Strength-based Versus Deficit-based Action Learning for Developing Leaders Teams and Organizations in Asia A Field Report of an Appreciative Inquiry and Action Learning Practitioner. | Tsui Dorothy 2021 May 01 | Published in Journal AI Practitioner Volume 23 Issue 2 Page 51. | ISSN:1741-8224,1,0,0,1,1,2,50,50,0,0,0,0,0
"getit.library.nyu.edu/resolve?genre=article&isbn=&issn=17449642&title=Ethics and education&volume=16&issue=3&date=20210101&atitle=A defence of parental compromise concerning veganism&aulast=Hunt, Marcus William&spage=392&sid=EBSCO:British Library Document Supply Centre Inside Serials & Conference Proceedings=&pid=Hunt, Marcus Williamvdc.100123795910.0x00000120210101British Library Document Supply Centre Inside Serials & Conference Proceedings=",Article | A defence of parental compromise concerning veganism | Hunt Marcus William 2021 Jan 01 | Published in Journal Ethics and education Volume 16 Issue 3 Page 392. | ISSN:1744-9642,2,0,0,2,2,4,50,50,0,0,0,0,0
"getit.library.nyu.edu/resolve?genre=article&isbn=&issn=17449855&title=Journal of Postcolonial Writing&volume=41&issue=2&date=20051101&atitle=The ethnography of nostalgia.&aulast=Quayson, Ato&spage=131&sid=EBSCO:Humanities Source&pid=Quayson, Ato1844869820051101Humanities Source",Article | The ethnography of nostalgia. | Quayson Ato 2005 Nov 01 | Published in Journal Journal of Postcolonial Writing Volume 41 Issue 2 Page 131. | ISSN:1744-9855,1,0,0,1,1,2,50,50,0,0,0,0,0
"getit.library.nyu.edu/resolve?genre=article&isbn=&issn=17539129&title=Communication, Culture & Critique=&volume=&issue=&date=&atitle=&aulast=&spage=&sid=EBSCO:Communication & Mass Media Complete -- Publications=&pid=Communication & Mass Media Complete -- Publications=",Article | Communication Culture |  | ISSN:1753-9129 | undefined,0,0,3,0,3,3,0,100,0,0,0,0,0
"getit.library.nyu.edu/resolve?genre=article&isbn=&issn=1755599X&title=International Emergency Nursing&volume=39&issue=&date=20180701&atitle=Violence towards emergency nurses: A narrative review of theories and frameworks.&aulast=Ramacciati, Nicola&spage=2&sid=EBSCO:CINAHL Complete&pid=Ramacciati, Nicola13022455420180701CINAHL Complete",Article | Violence towards emergency nurses A narrative review of theories and frameworks. | Ramacciati Nicola 2018 Jul 01 | Published in Journal International Emergency Nursing Volume 39 Page 2. | ISSN:1755-599X,0,0,1,0,1,1,0,100,0,0,0,0,0
"getit.library.nyu.edu/resolve?genre=article&isbn=&issn=17945887&title=Co-herencia&volume=10&issue=19&date=20130101&atitle=A political approach on Pablo Escobar&aulast=Duncan, G.&spage=235&sid=EBSCO:Scopus\u00ae&pid=Duncan, G.edselc.2-52.0-8489180237320130101Scopus\u00ae",Article | A political approach on Pablo Escobar | Duncan G 2013 Jan 01 | Published in Journal Co-herencia Volume 10 Issue 19 Page 235. | ISSN:1794-5887,2,1,1,3,3,6,50,50,0,0,0,0,0
getit.library.nyu.edu/resolve?genre=article&isbn=&issn=18285961&title=Disegnare con&volume=13&issue=25&date=20201201&atitle=The virtual reconstruction of the historic districts of Shanghai European identity in traditional Chinese architecture&aulast=Sandro Parrinello&spage=1&sid=EBSCO:Directory of Open Access Journals&pid=Sandro Parrinelloedsdoj.862f0d857461468395d17a5024b94bc920201201Directory of Open Access Journals,Article | The virtual reconstruction of the historic districts of Shanghai European identity in traditional Chinese architecture | Sandro Parrinello 2020 Dec 01 | Published in Journal Disegnare con Volume 13 Issue 25 Page 1. | ISSN:1828-5961,1,0,0,1,1,2,50,50,0,0,0,0,0
getit.library.nyu.edu/resolve?genre=article&isbn=&issn=18398782&title=Australian Journal of Child and Family Health Nursing&volume=&issue=&date=&atitle=&aulast=&spage=&sid=EBSCO:The Serials Directory&pid=096885945The Serials Directory,Article | Australian Journal of Child and Family Health Nursing |  | ISSN:1839-8782 | undefined,0,0,3,0,3,3,0,100,0,0,0,0,0
"getit.library.nyu.edu/resolve?genre=article&isbn=&issn=18694195&title=SERIEs&volume=5&issue=2-3&date=20140801&atitle=The real estate and credit bubble: evidence from Spain&aulast=Akin, O.&spage=223&sid=EBSCO:Scopus\u00ae&pid=Akin, O.edselc.2-52.0-8492016067520140801Scopus\u00ae",Article | The real estate and credit bubble evidence from Spain | Akin O 2014 Aug 01 | Published in Journal SERIEs Volume 5 Issue 2-3 Page 223. | ISSN:1869-4187,2,0,0,2,2,4,50,50,0,0,0,0,0
"getit.library.nyu.edu/resolve?genre=article&isbn=&issn=18739857&title=Middle East Journal of Culture & Communication=&volume=9&issue=2&date=20160501&atitle=Love, Mobile Phones and the Codification of Intimacy in Contemporary Yemen.&aulast=Nevola, Luca&spage=147&sid=EBSCO:Communication & Mass Media Complete=&pid=Nevola, Luca11653137420160501Communication & Mass Media Complete=",Article | Love Mobile Phones and the Codification of Intimacy in Contemporary Yemen. | Nevola Luca 2016 May 01 | Published in Journal Middle East Journal of Culture Volume 9 Issue 2 Page 147. | ISSN:1873-9857,4,0,0,4,4,8,50,50,0,0,0,0,0
getit.library.nyu.edu/resolve?genre=article&isbn=&issn=18762026&title=Asian journal of psychiatry&volume=&issue=&date=20220506&atitle=Digital determinants of public mental health and wellbeing in Shanghai during the 2022 lockdown.&aulast=Hall BJ&spage=103155&sid=EBSCO:MEDLINE with Full Text&pid=Hall BJ3553792520220506MEDLINE with Full Text,Article | Digital determinants of public mental health and wellbeing in Shanghai during the 2022 lockdown. | Hall BJ 2022 May 06 | Published in Journal Asian journal of psychiatry Page 103155. | ISSN:1876-2018,1,0,0,1,1,2,50,50,0,0,0,0,0
getit.library.nyu.edu/resolve?genre=article&isbn=&issn=18831958&title=&volume=65&issue=4&date=20210101&atitle=Average rate of ridge resorption in denture treatment: A Systematic Review&aulast=Kazunori Ikebe&spage=429&sid=EBSCO:J-STAGE&pid=Kazunori Ikebeedsjst.jpr.65.4.65.JPR.D.20.0007520210101J-STAGE,Article | Average rate of ridge resorption in denture treatment A Systematic Review | Kazunori Ikebe 2021 Jan 01 | Published in Journal JOURNAL OF PROSTHODONTIC RESEARCH Volume 65 Issue 4 Page 429. | ISSN:1883-1958,0,2,2,2,2,4,50,50,0,0,0,0,0
getit.library.nyu.edu/resolve?genre=article&isbn=&issn=19046022&title=Otherness: Essays and Studies&volume=1&issue=1&date=20190301&atitle=\,Article | \ | 2019 Mar 01 | Published in Journal Otherness Essays and Studies Volume 1 Issue 1. | ISSN:1904-6022,1,0,0,1,1,2,50,50,0,0,0,0,0
getit.library.nyu.edu/resolve?genre=article&isbn=&issn=19302045&title=Texas Journal on Civil Liberties & Civil Rights=&volume=&issue=&date=&atitle=&aulast=&spage=&sid=EBSCO:Legal Source Publications&pid=Legal Source Publications,Article | Texas Journal on Civil Liberties |  | ISSN:1930-2045 | undefined,1,0,4,1,5,6,17,83,0,0,0,0,0
"getit.library.nyu.edu/resolve?genre=article&isbn=&issn=19804369&title=Hist\u00f3ria (S\u00e3o Paulo)&volume=33&issue=1&date=20140601&atitle='Islam' as the national identity for the formation of Pakistan: the political thought of Muhammad Iqbal and Abu'l 'Ala Mawdudi / O 'Isl\u00e3' como identidade nacional para a forma\u00e7\u00e3o do Paquist\u00e3o: o pensamento politico de Muhammad Iqbal e Abu'l 'Ala Mawdudi&aulast=Mohomed, Carimo&spage=317&sid=EBSCO:SciELO&pid=Mohomed, Carimoedssci.S0101.9074201400010001520140601SciELO",Article | 'Islam as the national identity for the formation of Pakistan the political thought of Muhammad Iqbal and Abu'l Ala Mawdudi O Isl\u00e3 como identidade nacional para a forma\u00e7\u00e3o do Paquist\u00e3o o pensamento politico de Muhammad Iqbal e Abu'l Ala Mawdudi | Mohomed Carimo 2014 Jun 01 | Published in Journal Hist\u00f3ria S\u00e3o Paulo Volume 33 Issue 1 Page 317. | ISSN:0101-9074,2,1,1,3,3,6,50,50,0,0,0,0,0
"getit.library.nyu.edu/resolve?genre=article&isbn=&issn=20144512&title=Documents d'An\u00e0lisi Geogr\u00e0fica&volume=&issue=&date=20190101&atitle=Bener\u00eda, Lourdes; Berik, G\u00fcnseli i Floro, Maria S. (2016). Gender, development and globalization: Economics as if all people mattered (second edition)&aulast=Casellas, Ant\u00f2nia&spage=&sid=EBSCO:EDS consolidated db (QD facet) no6&pid=Casellas, Ant\u00f2niaedsair.od.......613..a4f080a1403fd39f3dc125e12731d55420190101EDS consolidated db (QD facet) no6",Article | Bener\u00eda Lourdes | Casellas Antu00f2nia 2019 Jan 01 | Published in Journal Documents d'An\u00e0lisi Geogr\u00e0fica. | ISSN:0212-1573,2,0,0,2,2,4,50,50,0,0,0,0,0
getit.library.nyu.edu/resolve?genre=article&isbn=&issn=20403526&title=Transnational Cinemas&volume=&issue=&date=&atitle=&aulast=&spage=&sid=EBSCO:Film & Television Literature Index with Full Text -- Publications=&pid=Film & Television Literature Index with Full Text -- Publications=,Article | Transnational Cinemas |  | ISSN:2040-3526 | undefined,0,0,2,0,2,2,0,100,0,0,0,0,0
getit.library.nyu.edu/resolve?genre=article&isbn=&issn=20452322&title=Scientific reports&volume=10&issue=1&date=20200930&atitle=Rajyoga meditation induces grey matter volume changes in regions that process reward and happiness.&aulast=Babu MGR&spage=16177&sid=EBSCO:MEDLINE with Full Text&pid=Babu MGR3299936120200930MEDLINE with Full Text,Article | Rajyoga meditation induces grey matter volume changes in regions that process reward and happiness. | Babu MGR 2020 Sep 30 | Published in Journal Scientific reports Volume 10 Issue 1 Page 16177. | ISSN:2045-2322,5,1,1,6,6,12,50,50,0,0,0,0,0
"getit.library.nyu.edu/resolve?genre=article&isbn=&issn=20711050&title=SUSTAINABILITY&volume=13&issue=5&date=20210301&atitle=Climate Change along the Silk Road and Its Influence on Scythian Cultural Expansion and Rise of the Mongol Empire&aulast=Che, Ping&spage=2530&sid=EBSCO:Science Citation Index Expanded&pid=Che, Ping00062863520000120210301Science Citation Index Expanded",Article | Climate Change along the Silk Road and Its Influence on Scythian Cultural Expansion and Rise of the Mongol Empire | Che Ping 2021 Mar 01 | Published in Journal SUSTAINABILITY Volume 13 Issue 5 Page 2530. | ISSN:2071-1050,3,0,0,3,3,6,50,50,0,0,0,0,0
"getit.library.nyu.edu/resolve?genre=article&isbn=&issn=21470626&title=Journal of History, Culture & Art Research / Tarih K\u00fclt\u00fcr ve Sanat Arastirmalari Dergisi=&volume=&issue=&date=&atitle=&aulast=&spage=&sid=EBSCO:Academic Search Complete -- Publications&pid=Academic Search Complete -- Publications",Article | Journal of History Culture |  | ISSN:2147-0626 | undefined,0,0,2,0,2,2,0,100,0,0,0,0,0
getit.library.nyu.edu/resolve?genre=article&isbn=&issn=21504857&title=Journal of Graphic Novels & Comics=&volume=&issue=&date=&atitle=&aulast=&spage=&sid=EBSCO:Art & Architecture Source Publications=&pid=Art & Architecture Source Publications=,Article | Journal of Graphic Novels |  | ISSN:2150-4857 | undefined,0,0,1,0,1,1,0,100,0,0,0,0,0
"getit.library.nyu.edu/resolve?genre=article&isbn=&issn=2153599X&title=Religion, Brain & Behavior=&volume=10&issue=4&date=20200101&atitle=Religion makes--and unmakes--the status quo: religiosity and spirituality have opposing effects on conservatism via RWA and SDO&aulast=Lockhart, Christopher&spage=379&sid=EBSCO:Atla Religion Database&pid=Lockhart, ChristopherATLAi5IE20103100171620200101Atla Religion Database",Article | Religion makes and unmakes the status quo religiosity and spirituality have opposing effects on conservatism via RWA and SDO | Lockhart Christopher 2020 Jan 01 | Published in Journal Religion Brain Volume 10 Issue 4 Page 379. | ISSN:2153-599X,1,0,0,1,1,2,50,50,0,0,0,0,0
getit.library.nyu.edu/resolve?genre=article&isbn=&issn=21571074&title=International Journal of Critical Pedagogy&volume=&issue=&date=&atitle=&aulast=&spage=&sid=EBSCO:Education Source Publications&pid=Education Source Publications,Article | International Journal of Critical Pedagogy |  | ISSN:2157-1074 | undefined,0,0,2,0,2,2,0,100,0,0,0,0,0
"getit.library.nyu.edu/resolve?genre=article&isbn=&issn=21693536&title=IEEE Access, Access, IEEE&volume=8&issue=&date=20200101&atitle=A New Group Decision Making Method With Distributed Indeterminacy Form Under Neutrosophic Environment: An Introduction to Neutrosophic Social Choice Theory&aulast=Topal, S.&spage=42000&sid=EBSCO:IEEE Xplore Digital Library&pid=Topal, S.edseee.901598720200101IEEE Xplore Digital Library",Article | A New Group Decision Making Method With Distributed Indeterminacy Form Under Neutrosophic Environment An Introduction to Neutrosophic Social Choice Theory | Topal S 2020 Jan 01 | Published in Journal IEEE Access Access IEEE Volume 8 Page 42000. | ISSN:2169-3536,2,0,0,2,2,4,50,50,0,0,0,0,0
getit.library.nyu.edu/resolve?genre=article&isbn=&issn=21947511&title=International Journal of Bipolar Disorders&volume=8&issue=1&date=20200301&atitle=Mixed mood states and emotion-related urgency in bipolar spectrum disorders: a call for greater investigation&aulast=Jennie A. Jaggers&spage=1&sid=EBSCO:Directory of Open Access Journals&pid=Jennie A. Jaggersedsdoj.07456dd4dac045a09f1d87e89868189120200301Directory of Open Access Journals,Article | Mixed mood states and emotion-related urgency in bipolar spectrum disorders a call for greater investigation | Jennie A Jaggers 2020 Mar 01 | Published in Journal International Journal of Bipolar Disorders Volume 8 Issue 1 Page 1. | ISSN:2194-7511,4,1,1,5,5,10,50,50,0,0,0,0,0
"getit.library.nyu.edu/resolve?genre=article&isbn=&issn=24143030&title=Journal of West Indian Literature&volume=2&issue=2&date=20210401&atitle=Re-Articulations of the Flying Symbolic: Flying and Falling in Edwidge Danticat\u2019s Krik? Krak! and \u201cWithout Inspection\u201d&aulast=Carvour, Cole A.&spage=108&sid=EBSCO:MLA International Bibliography&pid=Carvour, Cole A.20212244353220210401MLA International Bibliography",Article | Re-Articulations of the Flying Symbolic Flying and Falling in Edwidge Danticat\u2019s Krik Krak and u201cWithout Inspection\u201d | Carvour Cole A 2021 Apr 01 | Published in Journal Journal of West Indian Literature Volume 2 Issue 2 Page 108. | ISSN:0258-8501,5,1,0,6,5,11,55,45,0,0,0,0,0
getit.library.nyu.edu/resolve?genre=article&isbn=&issn=24716839&title=Panorama&volume=5&issue=2&date=20191101&atitle=Chiura Obata: An American Modern&aulast=Michelle Yee&spage=&sid=EBSCO:Directory of Open Access Journals&pid=Michelle Yeeedsdoj.fcc51b6e53e4dca860455d7e2f4032420191101Directory of Open Access Journals,Article | Chiura Obata An American Modern | Michelle Yee 2019 Nov 01 | Published in Journal Panorama Volume 5 Issue 2. | ISSN:2471-6839,1,0,0,1,1,2,50,50,0,0,0,0,0
"getit.library.nyu.edu/resolve?genre=article&isbn=&issn=25898051&title=Religion & Gender=&volume=11&issue=1&date=20210101&atitle=Towards an 'Un-disciplined' Study of Muslim Women, Gender, Religion, and the Secular&aulast=Bogert, Kathrine van den&spage=121&sid=EBSCO:Atla Religion Database&pid=Bogert, Kathrine van denATLAi9KZ21070500021020210101Atla Religion Database",Article | Towards an Un-disciplined Study of Muslim Women Gender Religion and the Secular | Van Den Bogert Kathrine 2021 Jan 01 | Published in Journal Religion Volume 11 Issue 1 Page 121. | ISSN:2589-8051,3,0,0,3,3,6,50,50,0,0,0,0,0
"getit.library.nyu.edu/resolve?genre=article&isbn=&issn=AMHS&title=American History&volume=&issue=&date=20080107&atitle=Yellow Journalism and the Spanish-American War&aulast=&spage=&sid=EBSCO:ABC-CLIO Social Studies Databases, Academic Edition&pid=edsaca.119241220080107ABC-CLIO Social Studies Databases, Academic Edition",Article | Yellow Journalism and the Spanish-American War | 2008 Jan 07 | Published in Journal American History. | ISSN:1076-8866,1,0,3,1,4,5,20,80,0,0,0,0,0
getit.library.nyu.edu/resolve?genre=article&isbn=&issn=NBID.CNFE&title=CE Noticias Financieras: English&volume=&issue=&date=20211127&atitle=Omicron: New Coronavirus Variant May Be 15 Times More Contagious Than Original Virus&aulast=&spage=&sid=EBSCO:NewsBank&pid=1868778A70BC74A820211127NewsBank,"Article | Omicron New Coronavirus Variant May Be 15 Times More Contagious Than Original Virus | 2021 Nov 27 | Published in Journal CE Noticias Financieras English. | ",3,1,1,4,4,8,50,50,0,0,0,0,0
"getit.library.nyu.edu/resolve?genre=article&isbn=&issn=NBID.DNTB&title=Duluth News Tribune (MN)&volume=&issue=&date=20120322&atitle=Greek gods, road trips inspire Williams' music; These days, Dar Williams has a lot in common with kids who write reports on Hephaestus, the god of forge and fires.&aulast=Christa Lawler&spage=&sid=EBSCO:NewsBank&pid=Christa Lawler13DAC799B274522020120322NewsBank",Article | Greek gods road trips inspire Williams music | Christa Lawler 2012 Mar 22 | Published in Journal Duluth News Tribune MN  | ISSN:0896-9418,1,2,2,3,3,6,50,50,0,0,0,0,0
getit.library.nyu.edu/resolve?genre=article&isbn=&issn=NBID.LATB&title=Los Angeles Times (CA)&volume=&issue=&date=20041021&atitle=With the Kids; Room to stretch their fins; An expanded Cabrillo Marine Aquarium complex debuts.&aulast=Brenda Rees&spage=&sid=EBSCO:NewsBank - Archives&pid=Brenda Rees105E14F6E8E2CE3620041021NewsBank - Archives,Article | With the Kids | Brenda Rees 2004 Oct 21 | Published in Journal Los Angeles Times CA  | ISSN:0458-3035,0,0,2,0,2,2,0,100,0,0,0,0,0
getit.library.nyu.edu/resolve?genre=article&isbn=&issn=NBID.LATB&title=Los Angeles Times (CA)&volume=&issue=&date=20120930&atitle=ART; 'Regarding Warhol' and then some; A Metropolitan Museum of Art show aims to take the measure of Andy Warhol's continuing influence over the culture at large.&aulast=Meredith Blake&spage=&sid=EBSCO:NewsBank&pid=Meredith Blake141A39E1D28CFA4820120930NewsBank,Article | ART | Meredith Blake 2012 Sep 30 | Published in Journal Los Angeles Times CA  | ISSN:0458-3035,1,1,1,2,2,4,50,50,0,0,0,0,0
"getit.library.nyu.edu/resolve?genre=article&isbn=&issn=NBID.LUCKI&title=Irish Times (Dublin, Ireland)&volume=&issue=&date=20180419&atitle=Ethical as well as technological challenges to robotics and AI; What 'rights' have artificial intelligence objects, and can you embed a conscience?&aulast=Patrick Smyth&spage=11&sid=EBSCO:NewsBank&pid=Patrick Smyth16B6154F474AA36020180419NewsBank",Article | Ethical as well as technological challenges to robotics and AI | Patrick Smyth 2018 Apr 19 | Published in Journal Irish Times Dublin Ireland Page 11. | ISSN:0791-5144,1,3,2,4,3,7,57,43,0,0,0,0,0
"getit.library.nyu.edu/resolve?genre=article&isbn=&issn=NBID.MMSM&title=Malay Mail (Kuala Lumpur, Malaysia)&volume=&issue=&date=20210929&atitle='Ungardening,' 'wish-cycling': Do you know the new lingo related to the environment?&aulast=&spage=&sid=EBSCO:NewsBank&pid=185558C415FE5B1820210929NewsBank","Article | 'Ungardening wish-cycling Do you know the new lingo related to the environment? | 2021 Sep 29 | Published in Journal Malay Mail Kuala Lumpur Malaysia  | ",1,0,0,1,1,2,50,50,0,0,0,0,0
getit.library.nyu.edu/resolve?genre=article&isbn=&issn=NBID.MWSB&title=The Milwaukee Journal&volume=&issue=&date=19931024&atitle=Bus travel a way of life in Costa Rica&aulast=&spage=&sid=EBSCO:NewsBank - Archives&pid=0EB828055EE607EB19931024NewsBank - Archives,Article | Bus travel a way of life in Costa Rica | 1993 Oct 24 | Published in Journal The Milwaukee Journal. | ISSN:1052-4452,0,0,1,0,1,1,0,100,0,0,0,0,0
"getit.library.nyu.edu/resolve?genre=article&isbn=&issn=NBID.NCYT&title=North County Times (Escondido, CA)&volume=&issue=&date=20041028&atitle=Supporters, foes of Prop. 71 clash as election draws near&aulast=BRADLEY J. FIKES - Staff Writer&spage=&sid=EBSCO:NewsBank&pid=BRADLEY J. FIKES - Staff Writer13D0B03A710B05F020041028NewsBank","Article | Supporters foes of Prop 71 clash as election draws near | BRADLEY J FIKES Staff Writer 2004 Oct 28 | Published in Journal North County Times Escondido CA  | ",1,0,2,1,3,4,25,75,0,0,0,0,0
getit.library.nyu.edu/resolve?genre=article&isbn=&issn=NBID.NEWB&title=PR Newswire Europe&volume=&issue=&date=20171005&atitle=Global Protein Bar Market 2017-2021: Segmentation By Product Type & Distribution Channel=&aulast=&spage=&sid=EBSCO:NewsBank&pid=1675A91EB64A8F4020171005NewsBank,"Article | Global Protein Bar Market 2017-2021 Segmentation By Product Type | 2017 Oct 05 | Published in Journal PR Newswire Europe. | ",6,0,21,6,27,33,18,82,0,0,0,0,0
"getit.library.nyu.edu/resolve?genre=article&isbn=&issn=NBID.NWEC&title=Newsweek&volume=&issue=&date=20021021&atitle=Breaking Her Silence; Ten years ago Donna Tartt turned the literary world on its ear with her best seller, 'The Secret History.' Now she's getting ready to do it again. Say hello to 'The Little Friend.'&aulast=Malcolm Jones&spage=66&sid=EBSCO:NewsBank - Archives&pid=Malcolm Jones0F6D100BDA71A60420021021NewsBank - Archives","Article | Breaking Her Silence | Malcolm Jones 2002 Oct 21 | Published in Journal Newsweek Page 66. | ",0,0,14,0,14,14,0,100,0,0,0,0,0
getit.library.nyu.edu/resolve?genre=article&isbn=&issn=NBID.ORLB&title=THE ORLANDO SENTINEL&volume=&issue=&date=19930907&atitle=CENTRAL FLORIDA'S SAT STATS RAISE IMPORTANT QUESTIONS; CAN THE TEST PREDICT COLLEGE SUCCESS? BE FAIR TO WOMEN AND MINORITIES? REFLECT; SCHOOL STANDARDS? YOU HAVE ONE MINUTE.&aulast=By Beth Taylor of The Sentinel Staff&spage=&sid=EBSCO:NewsBank - Archives&pid=By Beth Taylor of The Sentinel Staff0EB4F1444C756C5319930907NewsBank - Archives,"Article | CENTRAL FLORIDA'S SAT STATS RAISE IMPORTANT QUESTIONS | By Beth Taylor of The Sentinel Staff 1993 Sep 07 | Published in Journal THE ORLANDO SENTINEL. | ",0,0,4,0,4,4,0,100,0,0,0,0,0
"getit.library.nyu.edu/resolve?genre=article&isbn=&issn=NBID.PNPB&title=Portland Press Herald (ME)&volume=&issue=&date=20191128&atitle=Movie review: Delightful whodunit 'Knives Out' is an embarrassment of riches; It's also a deceptively radical and empathetic message of acceptance, tolerance and wealth redistribution.&aulast=Katie WalshTribune News Service&spage=&sid=EBSCO:NewsBank&pid=Katie WalshTribune News Service1779AD7119AEC88820191128NewsBank","Article | Movie review Delightful whodunit Knives Out is an embarrassment of riches | Katie WalshTribune News Service 2019 Nov 28 | Published in Journal Portland Press Herald ME  | ",0,0,1,0,1,1,0,100,0,0,0,0,0
"getit.library.nyu.edu/resolve?genre=article&isbn=&issn=edsrbp&title=Daily Mirror&volume=&issue=&date=20100827&atitle=Katy Perry: Teenage Dream ***&aulast=Martin, Gavin&spage=&sid=EBSCO:Rock's Backpages&pid=Martin, Gavinedsrbp.2805720100827Rock's Backpages",Article | Katy Perry Teenage Dream  | Martin Gavin 2010 Aug 27 | Published in Journal Daily Mirror. | ISSN:1391-4782,1,0,7,1,8,9,11,89,0,0,0,0,0
"getit.library.nyu.edu/resolve?genre=article&isbn=&issn=edsrbp&title=i-D&volume=&issue=&date=19970901&atitle=Lil' Kim and Foxy Brown: Nasty Girls&aulast=Cole, Bethan&spage=&sid=EBSCO:Rock's Backpages&pid=Cole, Bethanedsrbp.2827319970901Rock's Backpages",Article | Lil Kim and Foxy Brown Nasty Girls | Cole Bethan 1997 Sep 01 | Published in Journal i-D. | ISSN:0894-5373,1,0,0,1,1,2,50,50,0,0,0,0,0
"getit.library.nyu.edu/resolve?genre=article&isbn=&issn=usnewyorkjjj&title=Foreign Affairs&volume=97&issue=2&date=20180301&atitle=The Rise of Illiberal Hegemony: Trump's Surprising Grand Strategy&aulast=Posen, Barry R.&spage=20&sid=EBSCO:HeinOnline&pid=Posen, Barry R.edshol.hein.journals.fora97.3320180301HeinOnline","Article | The Rise of Illiberal Hegemony Trump's Surprising Grand Strategy | Posen Barry R 2018 Mar 01 | Published in Journal Foreign Affairs Volume 97 Issue 2 Page 20. | ",1,0,9,1,10,11,9,91,0,0,0,0,0
"getit.library.nyu.edu/resolve?genre=article&isbn=9781493924509&issn=10643745&title=Mycobacteria Protocols&volume=1285&issue=&date=20150214&atitle=Targeted Gene Knockout and Essentiality Testing by Homologous Recombination&aulast=Parish, Tanya, Editor&spage=131&sid=EBSCO:SpringerProtocols&pid=Parish, Tanya, Editorspringer.A32B4ACA20150214SpringerProtocols",Article | Targeted Gene Knockout and Essentiality Testing by Homologous Recombination | Parish Tanya 2015 Feb 14 | Published in Journal Mycobacteria protocols Volume 1285 Page 131. | ISSN:1064-3745 ISBN:9781493924509,0,0,2,0,2,2,0,100,0,0,0,0,0
"getit.library.nyu.edu/resolve?genre=article&isbn=9781728189611&issn=2377634X&title=2020 IEEE Frontiers in Education Conference (FIE), Frontiers in Education Conference (FIE), 2020 IEEE&volume=&issue=&date=20201021&atitle=Engineering Ethics Education for Social Justice&aulast=Douglas, Elliot P.&spage=1&sid=EBSCO:IEEE Xplore Digital Library&pid=Douglas, Elliot P.edseee.927404120201021IEEE Xplore Digital Library",Article | Engineering Ethics Education for Social Justice | Douglas Elliot P 2020 Oct 21 | Published in Journal 2020 IEEE Frontiers in Education Conference FIE Frontiers in Education Conference FIE 2020 IEEE Page 1. | ISSN:0190-5848 ISBN:9781728189611,1,0,0,1,1,2,50,50,0,0,0,0,0
"getit.library.nyu.edu/resolve?genre=article&isbn=9789051834505&issn=0923411X&title=CRITICAL STUDIES&volume=3/4&issue=2//1/2&date=&atitle=The Dominant of Bakhtin's Philosophy: Dialogue and Carnival&aulast=Ivanov, V. V.&spage=3&sid=EBSCO:British Library Document Supply Centre Inside Serials & Conference Proceedings=&pid=Ivanov, V. V.CN000955693British Library Document Supply Centre Inside Serials & Conference Proceedings=",Article | The Dominant of Bakhtin's Philosophy Dialogue and Carnival | Ivanov V V 1993 | Published in Journal Bakhtin carnival and other subjects selected papers from the Fifth International Bakhtin Conference University of Manchester July 1991 Volume 3/4 Issue 2 1/2 Page 3. | ISSN:0923-411X ISBN:9789051834505,0,0,4,0,4,4,0,100,0,0,0,0,0
getit.library.nyu.edu/resolve?genre=article&sid=literatum:achs&aulast=Berson&aufirst=J.+A.&jtitle=J. Am. Chem. Soc.&date=1971&volume=93&spage=1546,Article | JOURNAL OF THE AMERICAN CHEMICAL SOCIETY | Berson J A 1971 | Published in Journal Volume 93 Page 1546. | ISSN:0002-7863,0,0,1,0,1,1,0,100,0,0,0,0,0
getit.library.nyu.edu/resolve?genre=article&sid=literatum:achs&aulast=Clark&aufirst=V.+M.&jtitle=Angew. Chem.&date=1964&volume=76&spage=712,Article | Angewandte Chemie | Clark V M 1964 | Published in Journal Volume 76 Page 712. | ISSN:0044-8249,0,0,1,0,1,1,0,100,0,0,0,0,0
getit.library.nyu.edu/resolve?genre=article&sid=literatum:achs&aulast=Dussault&aufirst=P.+H.&jtitle=Tetrahedron Lett.&date=1995&volume=36&spage=3658,Article | TETRAHEDRON LETTERS | Dussault P H 1995 | Published in Journal Volume 36 Page 3658. | ISSN:0040-4039,0,0,1,0,1,1,0,100,0,0,0,0,0
getit.library.nyu.edu/resolve?genre=article&sid=literatum:achs&aulast=Moffatt&aufirst=J.+G.&jtitle=J. Am. Chem. Soc.&date=1961&volume=83&spage=658,Article | JOURNAL OF THE AMERICAN CHEMICAL SOCIETY | Moffatt J G 1961 | Published in Journal Volume 83 Page 658. | ISSN:0002-7863,0,0,1,0,1,1,0,100,0,0,0,0,0
getit.library.nyu.edu/resolve?genre=article&sid=literatum:achs&aulast=Nakamura&aufirst=T.&jtitle=J. Phys. Org. Chem.&date=2010,Article | JOURNAL OF PHYSICAL ORGANIC CHEMISTRY | Nakamura T 2010 |  | ISSN:0894-3230,0,0,2,0,2,2,0,100,0,0,0,0,0
"getit.library.nyu.edu/resolve?genre=bookitem&isbn=&issn=&title=Express Tribune (Karachi, Pakistan)&volume=&issue=&date=&atitle=&aulast=&spage=&sid=EBSCO:Newspaper Source Plus -- Publications&pid=Newspaper Source Plus -- Publications",Book Chapter | Express Tribune Karachi Pakistan) |  |  | undefined,0,0,1,0,1,1,0,100,0,0,0,0,0
"getit.library.nyu.edu/resolve?genre=bookitem&isbn=0822340984&issn=&title=Espinosa, Gasto\u0301n and Garci\u0301a, Mario T., eds. MEXICAN AMERICAN RELIGIONS: SPIRITUALITY, ACTIVISM, AND CULTURE. Durham: Duke University Press, 2008., [57]-82&volume=&issue=&date=20080101&atitle=Pious colonialism: assessing a Church paradigm for Chicano identity&aulast=Stevens-Arroyo, Anthony M.&spage=&sid=EBSCO:Chicano Database&pid=Stevens-Arroyo, Anthony M.XCHD6689920080101Chicano Database",Book Chapter | Pious colonialism assessing a Church paradigm for Chicano identity | Stevens Arroyo Anthony M 2008 Jan 01 | Published in Book Mexican American religions spirituality activism and culture. | Publisher:Duke University Press ISBN:0822340984,0,0,5,0,5,5,0,100,0,0,0,0,0
"getit.library.nyu.edu/resolve?genre=bookitem&isbn=9781477307960&issn=&title=Hern\u00e1ndez-\u00c1vila, In\u00e9s and Cant\u00fa, Norma Elia, eds. ENTRE GUADALUPE Y MALINCHE: TEJANAS IN LITERATURE AND ART. Austin, TX: University of Texas Press, 2016., [267]-269&volume=&issue=&date=20160101&atitle=All our relations: our connections to land, family, friends&aulast=Cant\u00fa, Norma Elia&spage=267&sid=EBSCO:Chicano Database&pid=Cant\u00fa, Norma EliaXCHD7941220160101Chicano Database",Book Chapter | All our relations our connections to land family friends | Hernández-Avila Inés 2016 Jan 01 | Published in Book Entre Guadalupe y Malinche Tejanas in literature and art Page 267. | Publisher:University of Texas Press ISBN:9781477307960,0,0,3,0,3,3,0,100,0,0,0,0,0
"getit.library.nyu.edu/resolve?genre=citedby&id=doi:10.1016/j.tet.2008.12.046&sid=literatum:achs&jtitle=Tetrahedron&atitle=Synthesis+of+orthogonally+protected+optically+pure+ketopiperazine,+diketopiperazine,+ketodiazepane,+and+3-aminopyrrolidone+building+blocks+for+peptidomimetic+combinatorial+chemistry&aulast=Gellerman&aufirst=Gary&date=2009&volume=65&issue=7&spage=1389&epage=1396",Synthesis of orthogonally protected optically pure ketopiperazine diketopiperazine ketodiazepane and 3-aminopyrrolidone building blocks for peptidomimetic combinatorial chemistry | Gellerman Gary 2009 | Published in TETRAHEDRON Volume 65 Issue 7 Page 1389 1396. | ISSN:0040-4020 | undefined,0,0,1,0,1,1,0,100,0,1,0,0,0
getit.library.nyu.edu/resolve?genre=citedby&id=doi:10.1021/acs.jchemed.9b00464&sid=literatum:achs&jtitle=Journal of Chemical Education&atitle=Microwave+Synthesis+of+a+Prominent+LED+Phosphor+for+School+Students:+Chemistry\u2019s+Contribution+to+Sustainable+Lighting&aulast=Diekemper&aufirst=Dominik&date=2019&date=2019&date=2019&date=2019&date=16052019&date=05102019&date=18102019&volume=96&issue=12&spage=3018&epage=3024,Microwave Synthesis of a Prominent LED Phosphor for School Students Chemistry\u2019s Contribution to Sustainable Lighting | Diekemper Dominik 2019 | Published in JOURNAL OF CHEMICAL EDUCATION Volume 96 Issue 12 Page 3018 3024. | ISSN:0021-9584 | undefined,0,0,1,0,1,1,0,100,0,1,0,0,0
getit.library.nyu.edu/resolve?genre=citedby&id=doi:10.1021/acsanm.0c00785&sid=literatum:achs&jtitle=ACS Applied Nano Materials&atitle=Hybrid+Cellulose+Nanocrystal-Bonded+Carbon+Nanotubes/Carbon+Fiber+Polymer+Composites+for+Structural+Applications&aulast=Shariatnia&aufirst=Shadi&date=2020&date=2020&date=2020&date=2020&date=22032020&date=14052020&date=31052020&date=14052020&volume=3&issue=6&spage=5421&epage=5436,Hybrid Cellulose Nanocrystal-Bonded Carbon Nanotubes/Carbon Fiber Polymer Composites for Structural Applications | Shariatnia Shadi 2020 | Published in ACS APPLIED NANO MATERIALS Volume 3 Issue 6 Page 5421 5436. | ISSN:2574-0970 | undefined,0,0,1,0,1,1,0,100,0,1,0,0,0
"getit.library.nyu.edu/resolve?genre=citedby&id=doi:10.1289/EHP7396&sid=literatum:achs&jtitle=Environmental Health Perspectives&atitle=Cross-Sectional+Estimation+of+Endogenous+Biomarker+Associations+with+Prenatal+Phenols,+Phthalates,+Metals,+and+Polycyclic+Aromatic+Hydrocarbons+in+Single-Pollutant+and+Mixtures+Analysis+Approaches&aulast=Aung&aufirst=Max+T.&date=2021&volume=129&issue=3",Cross-Sectional Estimation of Endogenous Biomarker Associations with Prenatal Phenols Phthalates Metals and Polycyclic Aromatic Hydrocarbons in Single-Pollutant and Mixtures Analysis Approaches | Aung Max T 2021 | Published in ENVIRONMENTAL HEALTH PERSPECTIVES Volume 129 Issue 3. | ISSN:0091-6765 | undefined,0,0,10,0,10,10,0,100,0,1,0,0,0
getit.library.nyu.edu/resolve?rft_id=info:doi/10.3201/eid0501.990102,Article | The Economic Impact ofStaphylococcus aureusInfection in New York City Hospitals | Rubin Robert J 1999 | Published in Journal EMERGING INFECTIOUS DISEASES Volume 5 Issue 1 Page 9 17. | ISSN:1080-6040,8,3,1,11,9,20,55,45,0,0,0,0,0
getit.library.nyu.edu/resolve?rft_id=info:pmid/pmid:17131617&url_ver=Z39.88-2004&url_ctx_fmt=info:ofi/fmt:kev:mtx:ctx,Article | A dramaturgical analysis of shift report patterns with cost implications a case study. | Hays Mary M 2006 | Published in Journal NURSING ECONOMICS Volume 24 Issue 5 Page 253 62 227. | ISSN:0746-1739,6,1,1,7,7,14,50,50,0,0,0,0,0
getit.library.nyu.edu/resolve?sid=APA&url_ver=Z39.88-2004&rft.atitle=An introduction to pharmacotherapy for mental disorders.&rft.aufirst=John R.&rft.aulast=Hughes&rft.date=1992&rft.epage=125&rft.spage=101&rft.btitle=Psychopharmacology: Basic mechanisms and applied interventions.&rft.isbn=1-55798-158-2&rft.genre=bookitem&rft.pid=1992-98127-003&url_ver=Z39.88-2004&rft_val_fmt=info:ofi/fmt:kev:mtx:book&rft_id=info:doi/10.1037/10114-003,Book Chapter | An introduction to pharmacotherapy for mental disorders. | Hughes John R 1992 | Published in Book Psychopharmacology basic mechanisms and applied interventions Page 101 125. | Publisher:American Psychological Association ISBN:1557981582,0,0,2,0,2,2,0,100,0,0,0,0,0
getit.library.nyu.edu/resolve?sid=APA&url_ver=Z39.88-2004&rft.atitle=Cognitive load theory: Recent theoretical advances.&rft.aufirst=John&rft.aulast=Sweller&rft.date=2010&rft.epage=47&rft.spage=29&rft.btitle=Cognitive load theory.&rft.isbn=978-0-521-67758-5&rft.genre=bookitem&rft.pid=2010-09374-002&url_ver=Z39.88-2004&rft_val_fmt=info:ofi/fmt:kev:mtx:book&rft_id=info:doi/10.1017/CBO9780511844744.004,Book Chapter | Cognitive load theory Recent theoretical advances. | Sweller John 2010 | Published in Book Cognitive load theory Page 29 47. | Publisher:Cambridge University Press ISBN:9780521677585,0,0,2,0,2,2,0,100,0,0,0,0,0
getit.library.nyu.edu/resolve?sid=APA&url_ver=Z39.88-2004&rft.atitle=Cognitive-behavioral therapy.&rft.aufirst=Christie&rft.aulast=Jackson&rft.date=2009&rft.epage=263&rft.spage=243&rft.btitle=Treating complex traumatic stress disorders: An evidence-based guide.&rft.isbn=1-60623-039-5&rft.genre=bookitem&rft.pid=2009-04501-012&url_ver=Z39.88-2004&rft_val_fmt=info:ofi/fmt:kev:mtx:book,Book Chapter | Cognitive-behavioral therapy. | Jackson Christie 2009 | Published in Book Treating complex traumatic stress disorders an evidence-based guide Page 243 263. | Publisher:Guilford Press ISBN:1606230395,0,0,1,0,1,1,0,100,0,0,0,0,0
getit.library.nyu.edu/resolve?sid=APA&url_ver=Z39.88-2004&rft.atitle=Effects of early life adversity on immune function and cognitive performance: Results from the alspac cohort.&rft.aufirst=Jessica F.&rft.aulast=Holland&rft.date=2020-01&rft.epage=No Pagination Specified&rft.spage=No&rft_id=info:doi/10.1007/s00127-019-01813-8&rft.jtitle=Social Psychiatry and Psychiatric Epidemiology: The International Journal for Research in Social and Genetic Epidemiology and Mental Health Services&rft.issn=0933-7954&rft.eissn=1433-9285&rft.genre=article&rft.pid=2020-00523-001&url_ver=Z39.88-2004&rft_val_fmt=info:ofi/fmt:kev:mtx:journal,Article | Effects of early life adversity on immune function and cognitive performance Results from the alspac cohort. | Holland Jessica F 2020 Jan | Published in Journal SOCIAL PSYCHIATRY AND PSYCHIATRIC EPIDEMIOLOGY Volume 55 Issue 6 Page No No Pagination Specified. | ISSN:0933-7954,4,0,0,4,4,8,50,50,0,0,0,0,0
getit.library.nyu.edu/resolve?sid=APA&url_ver=Z39.88-2004&rft.atitle=Enhancing creativity.&rft.aufirst=Raymond S.&rft.aulast=Nickerson&rft.date=1999&rft.epage=430&rft.spage=392&rft.btitle=Handbook of creativity.&rft.isbn=0-521-57285-1&rft.genre=bookitem&rft.pid=1998-08125-020&url_ver=Z39.88-2004&rft_val_fmt=info:ofi/fmt:kev:mtx:book,Book Chapter | Enhancing creativity. | Nickerson Raymond S 1999 | Published in Book Handbook of creativity Page 392 430. | Publisher:Cambridge University Press ISBN:0521572851,0,0,2,0,2,2,0,100,0,0,0,0,0
"getit.library.nyu.edu/resolve?sid=APA&url_ver=Z39.88-2004&rft.atitle=Essentialism as a generative theory of classification.&rft.aufirst=Bob&rft.aulast=Rehder&rft.date=2007&rft.epage=207&rft.spage=190&rft.btitle=Causal learning: Psychology, philosophy, and computation.&rft.isbn=0-19-517680-4&rft.genre=bookitem&rft.pid=2007-01301-012&url_ver=Z39.88-2004&rft_val_fmt=info:ofi/fmt:kev:mtx:book&rft_id=info:doi/10.1093/acprof:oso/9780195176803.003.0013",Book Chapter | Essentialism as a generative theory of classification. | Rehder Bob 2007 | Published in Book Causal learning psychology philosophy and computation Page 190 207. | Publisher:Oxford University Press ISBN:0195176804,0,0,3,0,3,3,0,100,0,0,0,0,0
getit.library.nyu.edu/resolve?sid=APA&url_ver=Z39.88-2004&rft.atitle=Human rights education.&rft.aufirst=Felisa&rft.aulast=Tibbitts&rft.date=2011&rft.epage=117&rft.spage=87&rft.btitle=Teaching and studying social issues: Major programs and approaches.&rft.isbn=978-1-61735-044-3&rft.genre=bookitem&rft.pid=2011-01469-005&url_ver=Z39.88-2004&rft_val_fmt=info:ofi/fmt:kev:mtx:book,Book Chapter | Human rights education. | Tibbitts Felisa 2011 | Published in Book Teaching and studying social issues major programs and approaches Page 87 117. | Publisher:Information Age ISBN:9781617350443,0,0,4,0,4,4,0,100,0,0,0,0,0
getit.library.nyu.edu/resolve?sid=APA&url_ver=Z39.88-2004&rft.atitle=Interventions for mothers during pregnancy and postpartum: Behavioral and pharmacological approaches.&rft.aufirst=Deidre Byrnes&rft.aulast=Pereira&rft.date=2002&rft.epage=166&rft.spage=141&rft.btitle=Innovative approaches to health psychology: Prevention and treatment lessons from AIDS.&rft.isbn=1-55798-913-3&rft.genre=bookitem&rft.pid=2002-18428-006&url_ver=Z39.88-2004&rft_val_fmt=info:ofi/fmt:kev:mtx:book&rft_id=info:doi/10.1037/10475-006,Book Chapter | Interventions for mothers during pregnancy and postpartum Behavioral and pharmacological approaches. | Pereira Deidre Byrnes 2002 | Published in Book Innovative approaches to health psychology prevention and treatment lessons from AIDS Page 141 166. | Publisher:American Psychological Association ISBN:1557989133,0,0,2,0,2,2,0,100,0,0,0,0,0
"getit.library.nyu.edu/resolve?sid=APA&url_ver=Z39.88-2004&rft.atitle=Media influences on body image.&rft.aufirst=Michael P.&rft.aulast=Levine&rft.date=2011&rft.epage=109&rft.spage=101&rft.btitle=Body image: A handbook of science, practice, and prevention.&rft.isbn=978-1-60918-182-6&rft.genre=bookitem&rft.pid=2011-20792-012&url_ver=Z39.88-2004&rft_val_fmt=info:ofi/fmt:kev:mtx:book",Book Chapter | Media influences on body image. | Thomas F Cash 2011 | Published in Book Body image a handbook of science practice and prevention Page 101 109. | Publisher:Guilford Press ISBN:9781609181826,0,0,2,0,2,2,0,100,0,0,0,0,0
"getit.library.nyu.edu/resolve?sid=APA&url_ver=Z39.88-2004&rft.atitle=Temperament, Attention, and the Development of Self-Regulation.&rft.aufirst=Mary K.&rft.aulast=Rothbart&rft.date=2006&rft.epage=357&rft.spage=338&rft.btitle=Blackwell handbook of early childhood development.&rft.isbn=1-4051-2073-8&rft.genre=bookitem&rft.pid=2006-04286-017&url_ver=Z39.88-2004&rft_val_fmt=info:ofi/fmt:kev:mtx:book&rft_id=info:doi/10.1002/9780470757703.ch17",Book Chapter | Temperament Attention and the Development of Self-Regulation. | Rothbart Mary K 2006 | Published in Book Blackwell handbook of early childhood development Page 338 357. | Publisher:Blackwell Pub ISBN:1405120738,0,0,5,0,5,5,0,100,0,0,0,0,0
getit.library.nyu.edu/resolve?sid=APA&url_ver=Z39.88-2004&rft.atitle=The dyadic regulation of affect.&rft.aufirst=Diana&rft.aulast=Fosha&rft.date=2001-02&rft.epage=242&rft.spage=227&rft_id=info:doi/10.1002/1097-4679(200102)57:23.0.CO;2-1&rft.jtitle=Journal of Clinical Psychology&rft.volume=57&rft.issue=2&rft.issn=0021-9762&rft.eissn=1097-4679&rft.genre=article&rft.pid=2001-14405-006&url_ver=Z39.88-2004&rft_val_fmt=info:ofi/fmt:kev:mtx:journal,Article | The dyadic regulation of affect. | Fosha Diana 2001 Feb | Published in Journal JOURNAL OF CLINICAL PSYCHOLOGY Volume 57 Issue 2 Page 227 242. | ISSN:0021-9762,0,4,2,4,2,6,67,33,0,0,0,0,0
"getit.library.nyu.edu/resolve?sid=APA&url_ver=Z39.88-2004&rft.atitle=The manifestation of gender microaggressions.&rft.aufirst=Christina M.&rft.aulast=Capodilupo&rft.date=2010&rft.epage=216&rft.spage=193&rft.btitle=Microaggressions and marginality: Manifestation, dynamics, and impact.&rft.isbn=978-0-470-49139-3&rft.genre=bookitem&rft.pid=2011-12742-009&url_ver=Z39.88-2004&rft_val_fmt=info:ofi/fmt:kev:mtx:book",Book Chapter | The manifestation of gender microaggressions. | Derald Wing Sue 2010 | Published in Book Microaggressions and marginality manifestation dynamics and impact Page 193 216. | Publisher:Wiley ISBN:9780470491393,0,0,1,0,1,1,0,100,0,0,0,0,0
getit.library.nyu.edu/resolve?sid=APA&url_ver=Z39.88-2004&rft.btitle=The prefrontal cortex: Executive and cognitive functions.&rft.aufirst=Angela C.&rft.aulast=Roberts&rft.date=1998&rft.isbn=0-19-852442-0&rft.genre=book&rft.pid=1999-02185-000&url_ver=Z39.88-2004&rft_val_fmt=info:ofi/fmt:kev:mtx:book&rft_id=info:doi/10.1093/acprof:oso/9780198524410.001.0001,Book | The prefrontal cortex executive and cognitive functions | Roberts Angela C 1998 |  | Publisher:Oxford University Press ISBN:0198524420,0,0,2,0,2,2,0,100,0,0,0,0,0
getit.library.nyu.edu/resolve?sid=APA&url_ver=Z39.88-2004&rft.btitle=Toward a new psychology of gender.&rft.aufirst=Mary M.&rft.aulast=Gergen&rft.date=1997&rft.isbn=0-415-91307-1&rft.genre=book&rft.pid=1997-97379-000&url_ver=Z39.88-2004&rft_val_fmt=info:ofi/fmt:kev:mtx:book,Book | Toward a new psychology of gender | Mary M Gergen 1997 |  | Publisher:Routledge ISBN:0415913071,0,0,1,0,1,1,0,100,0,0,0,0,0
"getit.library.nyu.edu/resolve?sid=Brepols:aph&genre=bookitem&aulast=Hannah&aufirst= Robert&isbn=9781441188762&title=Written space in the Latin West, 200 BC to AD 300&atitle=Time in written spaces&pages=83-102&date=2013&id=doi:&__charset=utf8",Book Chapter | Time in written spaces | Hannah Robert 2013 | Published in Book Written space in the Latin West 200 BC to AD 300 Page 83 102. | Publisher:Bloomsbury Academic ISBN:9781441188762,0,0,3,0,3,3,0,100,0,0,0,0,0
"getit.library.nyu.edu/resolve?sid=CAS:CAPLUS AND MEDLINE&issn=0947-6539&lissn=0947-6539&volume=7&issue=13&coden=CEUJED&genre=article&id=doi:10.1002/1521-3765(20010702)7:13<2933::aid-chem2933>3.0.co;2-e&date=2001&spage=2940&epage=2956&pages=2940-2956&title=Chemistry - A European Journal&atitle=Synthesis of lipidated eNOS peptides by combining enzymatic, noble metal- and acid-mediated protecting group techniques with solid phase peptide synthesis and fragment condensation in solution&au=Machauer, Rainer&aulast=Machauer&aufirst=Rainer&pid=<authfull>Machauer, Rainer</authfull>",Article | Synthesis of lipidated eNOS peptides by combining enzymatic noble metal and acid-mediated protecting group techniques with solid phase peptide synthesis and fragment condensation in solution | Machauer Rainer 2001 | Published in Journal Chemistry A European Journal Volume 7 Issue 13 Page 2940 2956. | ISSN:0947-6539,0,1,1,1,1,2,50,50,0,0,0,0,0
"getit.library.nyu.edu/resolve?sid=CAS:CAPLUS&issn=0168-3659&volume=158&issue=2&coden=JCREEC&genre=article&date=2012&spage=215&epage=223&title=Journal of Controlled Release&stitle=J. Controlled Release&atitle=Polypeptide conjugates of D-penicillamine and idarubicin for anticancer therapy&id=doi:10.1016/j.jconrel.2011.10.027&aulast=Wadhwa&aufirst=Saurabh&pid=<authfull>Wadhwa, Saurabh</authfull><source>Journal of Controlled Release (2012), 158, (2), 215-223. Publisher: (Elsevier B.V., ) CODEN:JCREEC ISSN:0168-3659.</source>",Article | Polypeptide conjugates of D-penicillamine and idarubicin for anticancer therapy | Wadhwa Saurabh 2012 | Published in Journal Journal of Controlled Release Volume 158 Issue 2 Page 215 223. | ISSN:0168-3659,0,0,1,0,1,1,0,100,0,0,0,0,0
"getit.library.nyu.edu/resolve?sid=CAS:MEDLINE&eissn=1364-548X&lissn=1359-7345&volume=57&issue=73&genre=article&id=pmid:34519302&date=2021&spage=9244&epage=9247&pages=9244-9247&title=Chemical communications (Cambridge, England)&stitle=Chem Commun (Camb)&atitle=Enantioselective vinylogous-Mukaiyama-type dearomatisation by anion-binding catalysis&au=Kaur Kirandeep&aulast=Kirandeep&aufirst=Kaur&pid=<authfull>Kaur Kirandeep</authfull><source>Chemical communications (Cambridge, England) (2021), 57, (73), 9244-9247.</source>",Article | Enantioselective vinylogous-Mukaiyama-type dearomatisation by anion-binding catalysis | Kaur Kirandeep 2021 | Published in Journal Chemical communications Cambridge England Volume 57 Issue 73 Page 9244 9247. | ISSN:1359-7345,0,0,1,0,1,1,0,100,0,0,0,0,0
getit.library.nyu.edu/resolve?sid=Elsevier:Scopus&_service_type=getFullTxt&issn=10643745&isbn=&volume=1688&issue=&spage=55&epage=66&pages=55-66&artnum=&date=2018&id=doi:10.1007/978-1-4939-7386-6_3&title=Methods+in+Molecular+Biology&atitle=Afterglow+solid-state+NMR+spectroscopy&aufirst=G.&auinit=G.&auinit1=G&aulast=Abramov,Article | Afterglow solid-state NMR spectroscopy | Abramov Gili 2018 | Published in Journal Protein NMR methods and protocols Volume 1688 Page 55 66. | ISSN:1064-3745 ISBN:1493973851,0,0,2,0,2,2,0,100,0,0,0,0,0
getit.library.nyu.edu/resolve?sid=FirstSearch:WorldCat&genre=book&isbn=9780190876975&title=TALKING+LIKE+CHILDREN+:+language+and+the+production+of+age+in+the+marshall+islands.&date=2019&aulast=BERMAN&aufirst=ELISE&id=doi:&pid=1055262759<fssessid>0</fssessid>&url_ver=Z39.88-2004&rfr_id=info:sid/firstsearch.oclc.org:WorldCat&rft_val_fmt=info:ofi/fmt:kev:mtx:book&rft.genre=book&req_dat=<sessionid>0</sessionid>&rfe_dat=<accessionnumber>1055262759</accessionnumber>&rft_id=info:oclcnum/1055262759&rft_id=urn:ISBN:9780190876975&rft.aulast=BERMAN&rft.aufirst=ELISE&rft.title=TALKING+LIKE+CHILDREN+:+language+and+the+production+of+age+in+the+marshall+islands.&rft.date=2019&rft.isbn=9780190876975&rft.place=[Place+of+publication+not+identified]&rft.pub=OXFORD+UNIV+Press+US&rft.genre=book,Book | Talking like children language and the production of age in the Marshall Islands | Berman Elise 2019 |  | Publisher:OXFORD UNIV Press US ISBN:9780190876975,0,0,3,0,3,3,0,100,0,0,0,0,0
getit.library.nyu.edu/resolve?sid=FirstSearch:WorldCat&genre=book&isbn=9780192803405&title=The+enigmas+of+Easter+Island+:+island+on+the+edge&date=2003&aulast=Flenley&aufirst=John&id=doi:&pid=59368534<fssessid>0</fssessid><edition>[2nd+ed.].</edition>&url_ver=Z39.88-2004&rfr_id=info:sid/firstsearch.oclc.org:WorldCat&rft_val_fmt=info:ofi/fmt:kev:mtx:book&rft.genre=book&req_dat=<sessionid>0</sessionid>&rfe_dat=<accessionnumber>59368534</accessionnumber>&rft_id=info:oclcnum/59368534&rft_id=urn:ISBN:9780192803405&rft.aulast=Flenley&rft.aufirst=John&rft.title=The+enigmas+of+Easter+Island+:+island+on+the+edge&rft.date=2003&rft.isbn=9780192803405&rft.place=Oxford&rft.pub=Oxford+University+Press&rft.edition=[2nd+ed.].&rft.genre=book,Book | The enigmas of Easter Island island on the edge | Flenley John 2003 |  | Publisher:Oxford University Press ISBN:9780192803405,0,0,1,0,1,1,0,100,0,0,0,0,0
"getit.library.nyu.edu/resolve?sid=FirstSearch:WorldCat&genre=book&title=The+works+of+Jeremy+Bentham,&date=1843&aulast=Bentham&aufirst=Jeremy&id=doi:&pid=799330<fssessid>0</fssessid>&url_ver=Z39.88-2004&rfr_id=info:sid/firstsearch.oclc.org:WorldCat&rft_val_fmt=info:ofi/fmt:kev:mtx:book&rft.genre=book&req_dat=<sessionid>0</sessionid>&rfe_dat=<accessionnumber>799330</accessionnumber>&rft_id=info:oclcnum/799330&rft.aulast=Bentham&rft.aufirst=Jeremy&rft.title=The+works+of+Jeremy+Bentham,&rft.date=1843&rft.place=Edinburgh+;London&rft.pub=W.+Tait;;Simpkin++Marshall&rft.genre=book","Book | The works of Jeremy Bentham, | Jeremy Bentham 1843 |  | Publisher:W Tait",0,0,3,0,3,3,0,100,0,0,0,0,0
"getit.library.nyu.edu/resolve?sid=FirstSearch:WorldCat&isbn=9780203159644&title=Hippocrates'+woman+:+reading+the+female+body+in+ancient+Greece&date=1998&aulast=King&aufirst=Helen&id=doi:&pid=49414914<fssessid>0</fssessid>&url_ver=Z39.88-2004&rfr_id=info:sid/firstsearch.oclc.org:WorldCat&rft_val_fmt=info:ofi/fmt:kev:mtx:book&rft.genre=unknown&req_dat=<sessionid>0</sessionid>&rfe_dat=<accessionnumber>49414914</accessionnumber>&rft_id=info:oclcnum/49414914&rft_id=urn:ISBN:9780203159644&rft.aulast=King&rft.aufirst=Helen&rft.title=Hippocrates'+woman+:+reading+the+female+body+in+ancient+Greece&rft.date=1998&rft.isbn=9780203159644&rft.place=London+;;New+York+:&rft.pub=Routledge,&rft.genre=unknown",Hippocrates woman reading the female body in ancient Greece | King Helen 1998 |  | ISBN:9780203159644 | undefined,0,0,4,0,4,4,0,100,0,0,0,0,0
getit.library.nyu.edu/resolve?sid=FirstSearch:WorldCat&isbn=9781479807185&title=Beyond+hashtags+:+racial+politics+and+black+digital+networks&date=2020&aulast=Florini&aufirst=Sarah&id=doi:&pid=1196176609<fssessid>0</fssessid>&url_ver=Z39.88-2004&rfr_id=info:sid/firstsearch.oclc.org:WorldCat&rft_val_fmt=info:ofi/fmt:kev:mtx:book&rft.genre=unknown&req_dat=<sessionid>0</sessionid>&rfe_dat=<accessionnumber>1196176609</accessionnumber>&rft_id=info:oclcnum/1196176609&rft_id=urn:ISBN:9781479807185&rft.aulast=Florini&rft.aufirst=Sarah&rft.title=Beyond+hashtags+:+racial+politics+and+black+digital+networks&rft.date=2020&rft.isbn=9781479807185&rft.genre=unknown,Beyond hashtags racial politics and black digital networks | Florini Sarah 2020 |  | ISBN:9781479807185 | undefined,0,0,5,0,5,5,0,100,0,0,0,0,0
getit.library.nyu.edu/resolve?sid=Inspec&genre=article&issn=2214-8604&date=2018&volume=23&issue=&spage=108&epage=20&title=Additive+Manufacturing&atitle=Strengthening+mechanisms+in+direct+metal+laser+sintered+AlSi10Mg:+Comparison+between+virgin+and+recycled+powders&aulast=Hadadzadeh&aufirst=A.&isbn=&id=DOI:10.1016/j.addma.2018.07.014&ABBR=19088882&arnumber=,Article | Strengthening mechanisms in direct metal laser sintered AlSi10Mg Comparison between virgin and recycled powders | Hadadzadeh A 2018 | Published in Journal Additive Manufacturing Volume 23 Page 108 20. | ISSN:2214-8604,0,0,1,0,1,1,0,100,0,0,0,0,0
getit.library.nyu.edu/resolve?sid=OVID:ovftdb&id=pmid:&id=doi:10.1177/1049909120952322&issn=1049-9091&isbn=&volume=38&issue=5&spage=448&pages=448-451&date=2021&title=American+Journal+of+Hospice+&+Palliative+Medicine=&atitle=\,Article | \ | Lagman Ruth L 2021 | Published in Journal American Journal of Hospice Volume 38 Issue 5 Page 448 451. | ISSN:1049-9091,0,0,1,0,1,1,0,100,0,0,0,0,0
"getit.library.nyu.edu/resolve?sid=OVID:ovftdb&id=pmid:&id=doi:10.3928/02793695-20130327-01&issn=0279-3695&isbn=&volume=51&issue=5&spage=28&pages=28-34&date=2013&title=Journal+of+Psychosocial+Nursing+&+Mental+Health+Services=&atitle=Prevention+Strategies+to+Reduce+Falls+in+Psychiatric+Settings.&aulast=Al-Khatib&pid=<author>Al-Khatib,+Yasser;MSN,+RN;Arnold,+Paul;RN,+BC;Brautigam,+Lois;RN,+BC;Chan-Domingo,+Letty;MSN,+CRNP;Gennello,+Barbara;BSN,+RN;Jaminola,+Edgardo;MA,+RN-BC;Meehan,+Kate;BSN,+RN;Modrzynski,+John;BSN,+RN;Nicolardi,+Carolyn;+MHA,+RN;Rasi,+L.J.;MSW,+LSW;Stockton,+David;BSN,+RN</author>&<AN>00005278-201351050-00010</AN>=&<DT>Article</DT>=",Article | Prevention Strategies to Reduce Falls in Psychiatric Settings. | Al-Khatib 2013 | Published in Journal Journal of Psychosocial Nursing Volume 51 Issue 5 Page 28 34. | ISSN:0279-3695,2,1,1,3,3,6,50,50,0,0,0,0,0
"getit.library.nyu.edu/resolve?sid=OVID:psycdb&id=pmid:&id=doi:10.1007/s12144-020-01012-8&issn=1046-1310&isbn=&volume=40&issue=6&spage=2610&pages=2610-2620&date=2021&title=Current+Psychology:+A+Journal+for+Diverse+Perspectives+on+Diverse+Psychological+Issues&atitle=A+qualitative+study+of+friendships+in+old+age:+The+case+of+a+nursing+home+in+Turkey.&aulast=Yavuz+Guler&pid=<author>Yavuz+Guler,+Cigdem;Cakmak,+Ilgin;Ayyildiz,+Yunus</author>&<AN>2021-53219-002</AN>=&<DT>Journal+Article</DT>=",Article | A qualitative study of friendships in old age The case of a nursing home in Turkey. | Yavuz Guler 2021 | Published in Journal Current Psychology A Journal for Diverse Perspectives on Diverse Psychological Issues Volume 40 Issue 6 Page 2610 2620. | ISSN:1046-1310,1,4,4,5,5,10,50,50,0,0,0,0,0
"getit.library.nyu.edu/resolve?sid=OVID:psycdb&id=pmid:&id=doi:10.1016/j.cbpra.2008.02.006&issn=1077-7229&isbn=&volume=15&issue=4&spage=387&pages=387-399&date=2008&title=Cognitive+and+Behavioral+Practice&atitle=Developing+cognitive+behavioral+therapy+to+prevent+depressive+relapse+in+youth.&aulast=Kennard&pid=<author>Kennard,+Betsy+D;Stewart,+Sunita+M;Hughes,+Jennifer+L;Jarrett,+Robin+B;Emslie,+Graham+J</author>&<AN>2009-02890-004</AN>=&<DT>Journal+Article</DT>=",Article | Developing cognitive behavioral therapy to prevent depressive relapse in youth. | Kennard 2008 | Published in Journal Cognitive and Behavioral Practice Volume 15 Issue 4 Page 387 399. | ISSN:1077-7229,0,1,1,1,1,2,50,50,0,0,0,0,0
"getit.library.nyu.edu/resolve?sid=OVID:psycdb&id=pmid:&id=doi:10.1037/rep0000212&issn=0090-5550&isbn=&volume=63&issue=2&spage=276&pages=276-285&date=2018&title=Rehabilitation+Psychology&atitle=Assessing+everyday+life+functional+activity+using+actual+reality+in+persons+with+MS.&aulast=Goverover&pid=<author>Goverover,+Yael;DeLuca,+John</author>&<AN>2018-26104-009</AN>=&<DT>Journal+Article</DT>=",Article | Assessing everyday life functional activity using actual reality in persons with MS. | Goverover 2018 | Published in Journal Rehabilitation Psychology Volume 63 Issue 2 Page 276 285. | ISSN:0090-5550,0,0,1,0,1,1,0,100,0,0,0,0,0
"getit.library.nyu.edu/resolve?sid=OVID:psycdb&id=pmid:&id=doi:10.1080/00207411.2017.1278964&issn=0020-7411&isbn=&volume=46&issue=2&spage=139&pages=139-156&date=2017&title=International+Journal+of+Mental+Health&atitle=Qualitative+participatory+evaluation+of+a+psychosocial+rehabilitation+program+for+individuals+with+severe+mental+illness.&aulast=Rouse&pid=<author>Rouse,+Jennifer;Mutschler,+Christina;McShane,+Kelly;Habal-Brosek,+Criss</author>&<AN>2017-17656-006</AN>=&<DT>Journal+Article</DT>=",Article | Qualitative participatory evaluation of a psychosocial rehabilitation program for individuals with severe mental illness. | Rouse 2017 | Published in Journal International Journal of Mental Health Volume 46 Issue 2 Page 139 156. | ISSN:0020-7411,0,2,2,2,2,4,50,50,0,0,0,0,0
"getit.library.nyu.edu/resolve?sid=OVID:psycdb&id=pmid:&id=doi:10.1186/s12888-015-0508-8&issn=1471-244X&isbn=&volume=15&issue=1&spage=&pages=&date=2015&title=BMC+Psychiatry&atitle=Preventive+Cognitive+Therapy+versus+Treatment+as+Usual+in+preventing+recurrence+of+depression:+Protocol+of+a+multi-centered+randomized+controlled+trial.&aulast=de+Jonge&pid=<author>de+Jonge,+Margo;Bockting,+Claudi+L.+H;Kikkert,+Martijn+J;Bosmans,+Judith+E;Dekker,+Jack+J.+M</author>&<AN>2015-29815-001</AN>=&<DT>Journal+Article</DT>=",Article | Preventive Cognitive Therapy versus Treatment as Usual in preventing recurrence of depression Protocol of a multi-centered randomized controlled trial. | de Jonge 2015 | Published in Journal BMC Psychiatry Volume 15 Issue 1. | ISSN:1471-244X,2,7,6,9,8,17,53,47,0,0,0,0,0
getit.library.nyu.edu/resolve?sid=google&auinit=AI&aulast=Wan-Xiu&atitle=Gender+differences+in+perceptions+of+climate+change+and+meteorological+disasters+in+China&id=doi:10.12006/j.issn.1673-1719.2017.085&title=Advances+in+Climate+Change+Research&volume=14&issue=3&date=2018&spage=318,Article | Gender differences in perceptions of climate change and meteorological disasters in China | Wan Xiu A I 2018 | Published in Journal Advances in Climate Change Research Volume 14 Issue 3 Page 318. | ISSN:1674-9278,3,0,1,3,4,7,43,57,0,0,0,0,0
getit.library.nyu.edu/resolve?sid=google&auinit=AN&aulast=Bazzano&atitle=What+health+service+support+do+families+need+for+optimal+breastfeeding?+An+in-depth+exploration+of+young+infant+feeding+practices+in+Cambodia&id=pmid:25733931,Article | What health service support do families need for optimal breastfeeding An in-depth exploration of young infant feeding practices in Cambodia | Bazzano Alessandra N 2015 | Published in Journal INTERNATIONAL JOURNAL OF WOMENS HEALTH Volume 7 Page 249 257. | ISSN:1179-1411,5,1,1,6,6,12,50,50,0,0,0,0,0
getit.library.nyu.edu/resolve?sid=google&auinit=AS&aulast=Adly&atitle=Can+Artificial+Intelligence+and+Internet+be+the+Solution+to+Prevent+the+Exponential+Spread+of+COVID-19?&id=pmid:32584780,Article | Can Artificial Intelligence and Internet be the Solution to Prevent the Exponential Spread of COVID-19? | Adly Afnan Sedky 2020 | Published in Journal Journal of Medical Internet Research Volume 22 Issue 8 Page e19104 e19104. | ISSN:1439-4456,3,3,2,6,5,11,55,45,0,0,0,0,0
"getit.library.nyu.edu/resolve?sid=google&auinit=BCH&aulast=Kuo&atitle=Predictors+of+acculturation+for+Chinese+adolescents+in+Canada:+Age+of+arrival,+length+of+stay,+social+class,+and+English+reading+ability&id=doi:10.1002/j.2161-1912.2004.tb00367.x&title=Journal+of+Multicultural+Counseling+and+Development&volume=32&issue=3&date=2004&spage=143&issn=0883-8534",Article | Predictors of acculturation for Chinese adolescents in Canada Age of arrival length of stay social class and English reading ability | Kuo Ben C H 2004 | Published in Journal Journal of Multicultural Counseling and Development Volume 32 Issue 3 Page 143 154. | ISSN:0883-8534,7,4,1,11,8,19,58,42,0,0,0,0,0
"getit.library.nyu.edu/resolve?sid=google&auinit=BF&aulast=Arnold&atitle=Cluster-randomised+controlled+trials+of+individual+and+combined+water,+sanitation,+hygiene+and+nutritional+interventions+in+rural+Bangladesh+and+Kenya:+the+WASH+Benefits+study+design+and+rationale&id=pmid:23996605",Article | Cluster-randomised controlled trials of individual and combined water sanitation hygiene and nutritional interventions in rural Bangladesh and Kenya the WASH Benefits study design and rationale | Arnold Benjamin F 2013 | Published in Journal BMJ OPEN Volume 3 Issue 8 Page e003476 e003476. | ISSN:2044-6055,4,2,2,6,6,12,50,50,0,0,0,0,0
getit.library.nyu.edu/resolve?sid=google&auinit=BI&aulast=Bittker&atitle=The+Bicentennial+of+the+Jurisprudence+of+Original+Intent;+The+Recent+Past&title=California+Law+Review&volume=77&date=1989&spage=235&issn=0008-1221,Article | The Bicentennial of the Jurisprudence of Original Intent | Bittker B I 1989 | Published in Journal California Law Review Volume 77 Page 235. | ISSN:0008-1221,3,1,1,4,4,8,50,50,0,0,0,0,0
getit.library.nyu.edu/resolve?sid=google&auinit=CA&aulast=Bail&atitle=Exposure+to+opposing+views+on+social+media+can+increase+political+polarization&id=pmid:30154168,Article | Exposure to opposing views on social media can increase political polarization | Bail Christopher A 2018 | Published in Journal PROCEEDINGS OF THE NATIONAL ACADEMY OF SCIENCES OF THE UNITED STATES OF AMERICA Volume 115 Issue 37 Page 9216 9221. | ISSN:0027-8424,0,0,3,0,3,3,0,100,0,0,0,0,0
"getit.library.nyu.edu/resolve?sid=google&auinit=CL&aulast=Perry&atitle=Changing+fruit+and+vegetable+consumption+among+children:+the+5-a-Day+Power+Plus+program+in+St.+Paul,+Minnesota.&id=pmid:9551002",Article | Changing fruit and vegetable consumption among children the 5-a-Day Power Plus program in St Paul Minnesota. | Perry C L 1998 | Published in Journal AMERICAN JOURNAL OF PUBLIC HEALTH Volume 88 Issue 4 Page 603 609. | ISSN:0090-0036,4,7,1,11,5,16,69,31,0,0,0,0,0
getit.library.nyu.edu/resolve?sid=google&auinit=CR&aulast=Hirsch&atitle=Implementing+The+Standards:+A+Core+Curriculum+for+Grades+9\u201312&id=doi:10.5951/MT.82.9.0696&title=The+Mathematics+Teacher&volume=82&issue=9&date=1989&spage=696&issn=0025-5769,Article | Implementing The Standards A Core Curriculum for Grades 9\u201312 | Hirsch 1989 | Published in Journal The Mathematics Teacher Volume 82 Issue 9 Page 696 701. | ISSN:0025-5769,1,0,1,1,2,3,33,67,0,0,0,0,0
getit.library.nyu.edu/resolve?sid=google&auinit=D&aulast=Ortega-Altamirano&atitle=Strategies+for+teaching+self-examination+of+the+breast+to+women+in+reproductive+age&id=pmid:10743395,Article | Strategies for teaching self-examination of the breast to women in reproductive age | Ortega Altamirano D 2000 | Published in Journal SALUD PUBLICA DE MEXICO Volume 42 Issue 1 Page 17 25. | ISSN:0036-3634,0,0,3,0,3,3,0,100,0,0,0,0,0
getit.library.nyu.edu/resolve?sid=google&auinit=DP&aulast=Appukuttan&atitle=Strategies+to+manage+patients+with+dental+anxiety+and+dental+phobia:+literature+review&id=pmid:27022303,Article | Strategies to manage patients with dental anxiety and dental phobia literature review | Appukuttan Deva Priya 2016 | Published in Journal Clinical Cosmetic and Investigational Dentistry Volume 8 Page 35 50. | ISSN:1179-1357,0,0,6,0,6,6,0,100,0,0,0,0,0
"getit.library.nyu.edu/resolve?sid=google&auinit=EA&aulast=Malvania&atitle=Prevalence+and+socio-demographic+correlates+of+dental+anxiety+among+a+group+of+adult+patients+attending+a+dental+institution+in+Vadodara+city,+Gujarat,+India&id=pmid:21525704",Article | Prevalence and socio-demographic correlates of dental anxiety among a group of adult patients attending a dental institution in Vadodara city Gujarat India | Malvania Ekta A 2011 | Published in Journal Indian Journal of Dental Research Volume 22 Issue 1 Page 179 180. | ISSN:0970-9290,3,2,2,5,5,10,50,50,0,0,0,0,0
getit.library.nyu.edu/resolve?sid=google&auinit=EC&aulast=Alexopoulos&atitle=Introduction+to+multivariate+regression+analysis&id=pmid:21487487,Article | Introduction to multivariate regression analysis | Alexopoulos E C 2010 | Published in Journal HIPPOKRATIA Volume 14 Issue Suppl 1 Page 23 28. | ISSN:1108-4189,1,1,1,2,2,4,50,50,0,0,0,0,0
getit.library.nyu.edu/resolve?sid=google&auinit=EC&aulast=Bunker&title=Nomadic+art+of+the+eastern+Eurasian+steppes:+The+Eugene+V.+Thaw+and+other+New+York+collections&genre=book&isbn=0300096887&date=2002,Book | Nomadic art of the eastern Eurasian steppes the Eugene V Thaw and other New York collections | Bunker Emma C 2002 |  | Publisher:Metropolitan Museum of Art Yale University Press ISBN:0300096887,0,0,1,0,1,1,0,100,0,0,0,0,0
getit.library.nyu.edu/resolve?sid=google&auinit=F&aulast=Cunha&atitle=Interpreting+the+evidence+on+life+cycle+skill+formation&id=doi:10.1016/S1574-0692(06)01012-9&title=Handbook+of+the+economics+of+education&volume=1&date=2006&spage=697&issn=1574-0692,Article | Interpreting the evidence on life cycle skill formation | Cunha 2006 | Published in Journal Handbook of the economics of education Volume 1 Page 697 812. | ISSN:1574-0692 ISBN:044451399X,1,0,2,1,3,4,25,75,0,0,0,0,0
getit.library.nyu.edu/resolve?sid=google&auinit=G&aulast=Amos&atitle=Alopecia+areata&id=pmid:22512484,Article | Alopecia areata | Gilhar Amos 2012 | Published in Journal NEW ENGLAND JOURNAL OF MEDICINE Volume 366 Issue 16 Page 1515 1525. | ISSN:0028-4793,3,3,1,6,4,10,60,40,0,0,0,0,0
getit.library.nyu.edu/resolve?sid=google&auinit=J&aulast=Phelps&atitle=Boosting+cites&id=pmid:21205655,Article | Boosting cites | Phelps Jacob 2010 | Published in Journal SCIENCE Volume 330 Issue 6012 Page 1752 1753. | ISSN:0036-8075,2,11,1,13,3,16,81,19,0,0,0,0,0
getit.library.nyu.edu/resolve?sid=google&auinit=J&aulast=Souza&atitle=The+Cold+War+and+the+World+Chess+Championship+final+in+1972:+some+analytical+and+correlational+possibilities&title=Revista+brasileira+de+educa\u00e7\u00e3o+f\u00edsica+e+esporte&volume=27&date=2013&spage=567&issn=1807-5509,Article | The Cold War and the World Chess Championship final in 1972 some analytical and correlational possibilities | Souza J 2013 | Published in Journal Revista brasileira de educa\u00e7\u00e3o f\u00edsica e esporte Volume 27 Page 567. | ISSN:1807-5509,0,0,2,0,2,2,0,100,0,0,0,0,0
getit.library.nyu.edu/resolve?sid=google&auinit=JX&aulast=Gao&atitle=Construction+of+a+high-quality+yeast+two-hybrid+library+and+its+application+in+identification+of+interacting+proteins+with+Brn1+in+Curvularia+lunata&id=pmid:26060429,Article | Construction of a high-quality yeast two-hybrid library and its application in identification of interacting proteins with Brn1 in Curvularia lunata | Gao Jin-Xin 2015 | Published in Journal PLANT PATHOLOGY JOURNAL Volume 31 Issue 2 Page 108 114. | ISSN:1598-2254,1,1,1,2,2,4,50,50,0,0,0,0,0
getit.library.nyu.edu/resolve?sid=google&auinit=L&aulast=Bian&atitle=Gender+stereotypes+about+intellectual+ability+emerge+early+and+influence+children\u2019s+interests&id=pmid:28126816,Article | Gender stereotypes about intellectual ability emerge early and influence children\u2019s interests | Bian Lin 2017 | Published in Journal SCIENCE Volume 355 Issue 6323 Page 389 391. | ISSN:0036-8075,2,11,1,13,3,16,81,19,0,0,0,0,0
getit.library.nyu.edu/resolve?sid=google&auinit=MM&aulast=Gorecka&atitle=The+impact+of+age-related+hearing+loss+and+lateralized+auditory+attention+on+spatiotemporal+parameters+of+gait+during+dual-tasking+among+community+dwelling+older+adults&id=doi:10.1016/j.exger.2018.07.015&title=Experimental+gerontology&volume=111&date=2018&spage=253&issn=0531-5565,Article | The impact of age-related hearing loss and lateralized auditory attention on spatiotemporal parameters of gait during dual-tasking among community dwelling older adults | Gorecka 2018 | Published in Journal Experimental gerontology Volume 111 Page 253 262. | ISSN:0531-5565,1,0,0,1,1,2,50,50,0,0,0,0,0
getit.library.nyu.edu/resolve?sid=google&auinit=N&aulast=Chino&atitle=Stroke+impairment+assessment+set+(SIAS)&id=doi:10.1007/978-4-431-68461-9_3,Book Chapter | Stroke impairment assessment set SIAS) | Chino Naoichi 1996 | Published in Book Functional Evaluation of Stroke Patients Page 19 31. | Publisher:Springer Japan ISBN:4431684638,0,0,2,0,2,2,0,100,0,0,0,0,0
getit.library.nyu.edu/resolve?sid=google&auinit=NA&aulast=Obeidat&atitle=Are+Jordanian+primary+healthcare+practitioners+fulfilling+their+potential+in+cancer+prevention+and+community+health?+Findings+from+a+cross-sectional+survey&id=pmid:28389495,Article | Are Jordanian primary healthcare practitioners fulfilling their potential in cancer prevention and community health Findings from a cross-sectional survey | Obeidat N A 2017 | Published in Journal BMJ OPEN Volume 7 Issue 4 Page e015269 e015269. | ISSN:2044-6055,0,0,6,0,6,6,0,100,0,0,0,0,0
"getit.library.nyu.edu/resolve?sid=google&auinit=P&aulast=Shankar&atitle=Association+of+food+insecurity+with+children's+behavioral,+emotional,+and+academic+outcomes:+a+systematic+review&id=doi:10.1097/DBP.0000000000000383&title=Journal+of+Developmental+&+Behavioral+Pediatrics=&volume=38&issue=2&date=2017&spage=135&issn=0196-206X",Article | Association of food insecurity with children's behavioral emotional and academic outcomes a systematic review | Shankar 2017 | Published in Journal Journal of Developmental Volume 38 Issue 2 Page 135 150. | ISSN:0196-206X,0,0,2,0,2,2,0,100,0,0,0,0,0
getit.library.nyu.edu/resolve?sid=google&auinit=RA&aulast=Neff&atitle=Discovering+heritage+and+more+by+studying+abroad&title=Diverse+Issues+in+Higher+Education&volume=18&issue=12&date=2001&spage=72&issn=1557-5411,Article | Discovering heritage and more by studying abroad | Neff R A 2001 | Published in Journal Diverse Issues in Higher Education Volume 18 Issue 12 Page 72. | ISSN:1557-5411,0,0,4,0,4,4,0,100,0,0,0,0,0
"getit.library.nyu.edu/resolve?sid=google&auinit=RG&aulast=Knight&atitle=Some+normative,+reliability,+and+factor+analytic+data+for+the+revised+UCLA+Loneliness+Scale&id=doi:10.1002/1097-4679(198803)44:2<203::AID-JCLP2270440218>3.0.CO;2-5&title=Journal+of+Clinical+Psychology&volume=44&issue=2&date=1988&spage=203&issn=0021-9762",Article | Some normative reliability and factor analytic data for the revised UCLA Loneliness Scale | Knight R G 1988 | Published in Journal Journal of Clinical Psychology Volume 44 Issue 2 Page 203. | ISSN:0021-9762,0,3,2,3,2,5,60,40,0,0,0,0,0
getit.library.nyu.edu/resolve?sid=google&auinit=S&aulast=Avery-Leaf&atitle=Dating+violence+education:+Prevention+and+early+intervention+strategies.&id=doi:10.1037/10455-004,Book Chapter | Dating violence education Prevention and early intervention strategies. | Avery-Leaf 2002 | Published in Book Preventing violence in relationships interventions across the life span Page 79 105. | Publisher:American Psychological Association ISBN:1557989117,0,0,2,0,2,2,0,100,0,0,0,0,0
getit.library.nyu.edu/resolve?sid=google&auinit=S&aulast=Guo&atitle=Malignancy+predicts+outcome+of+Takotsubo+syndrome:+a+systematic+review+and+meta-analysis&id=doi:10.1007/s10741-020-09917-z,Article | Malignancy predicts outcome of Takotsubo syndrome a systematic review and meta-analysis | Guo 2020 | Published in Journal HEART FAILURE REVIEWS Volume 25 Issue 3 Page 513 522. | ISSN:1382-4147,3,0,0,3,3,6,50,50,0,0,0,0,0
getit.library.nyu.edu/resolve?sid=google&auinit=S&aulast=Schmidt&atitle=The+Adult+Attachment+Scale+(AAS)-psychometric+evaluation+and+normation+of+the+German+version&id=pmid:15343479,Article | The Adult Attachment Scale AAS psychometric evaluation and normation of the German version | Schmidt Silke 2004 | Published in Journal PSYCHOTHERAPIE PSYCHOSOMATIK MEDIZINISCHE PSYCHOLOGIE Volume 54 Issue 9-10 Page 375 382. | ISSN:0937-2032,0,1,1,1,1,2,50,50,0,0,0,0,0
getit.library.nyu.edu/resolve?sid=google&auinit=SJ&aulast=Leslie&atitle=Expectations+of+brilliance+underlie+gender+distributions+across+academic+disciplines&id=pmid:25593183,Article | Expectations of brilliance underlie gender distributions across academic disciplines | Leslie Sarah-Jane 2015 | Published in Journal SCIENCE Volume 347 Issue 6219 Page 262 265. | ISSN:0036-8075,2,11,1,13,3,16,81,19,0,0,0,0,0
getit.library.nyu.edu/resolve?sid=google&auinit=TL&aulast=Ownsworth&atitle=A+randomised+controlled+trial+(RCT)+for+facilitating+goal+attainment+and+improving+psychosocial+function+following+acquired+brain+injury:+Comparison+of+three+intervention+formats&id=pmid:18509570,Article | A randomised controlled trial RCT for facilitating goal attainment and improving psychosocial function following acquired brain injury Comparison of three intervention formats | Ownsworth Tamara 2008 | Published in Journal JOURNAL OF REHABILITATION MEDICINE Volume 40 Issue 2 Page 81 88. | ISSN:1650-1977,0,2,1,2,1,3,67,33,0,0,0,0,0
getit.library.nyu.edu/resolve?sid=google&auinit=V&aulast=\u015ear&atitle=Revisiting+the+etiological+aspects+of+dissociative+identity+disorder:+a+biopsychosocial+perspective&id=pmid:28496375,Article | Revisiting the etiological aspects of dissociative identity disorder a biopsychosocial perspective | Şar Vedat 2017 | Published in Journal PSYCHOLOGY RESEARCH AND BEHAVIOR MANAGEMENT Volume 10 Page 137 146. | ISSN:1179-1578,3,1,1,4,4,8,50,50,0,0,0,0,0
getit.library.nyu.edu/resolve?sid=jstor:jstor&genre=article&title=The+Black+Scholar&atitle=Translating+\,Article | Translating  | Published in Journal The Black Scholar. | ISSN:0006-4246 | undefined,0,0,9,0,9,9,0,100,0,0,0,0,0
getit.library.nyu.edu/resolve?sid=jstor:jstor&genre=book&title=Blockchain+and+the+Law&isbn=9780674976429&eisbn=9780674985933,Book | Blockchain and the law the rule of code | De Filippi Primavera 2018 |  | Publisher:Harvard University Press ISBN:9780674976429,0,0,3,0,3,3,0,100,0,0,0,0,0
getit.library.nyu.edu/resolve?sid=jstor:jstor&genre=book&title=China+Urban&isbn=9780822326342&eisbn=9780822381334,Book | China urban ethnographies of contemporary culture | Nancy N Chen 2001 |  | Publisher:Duke University Press ISBN:9780822326342,0,0,4,0,4,4,0,100,0,0,0,0,0
getit.library.nyu.edu/resolve?sid=jstor:jstor&genre=book&title=Cosmologies+of+Credit&isbn=9780822347927&eisbn=9780822393160,Book | Cosmologies of credit transnational mobility and the politics of destination in China | Chu Julie Y 2010 |  | Publisher:Duke University Press ISBN:9780822347927,0,0,5,0,5,5,0,100,0,0,0,0,0
getit.library.nyu.edu/resolve?sid=jstor:jstor&genre=book&title=Culinary+Nostalgia&isbn=9780804760126&eisbn=9780804787468,Book | Culinary nostalgia regional food culture and the urban experience in Shanghai | Swislocki Mark 2009 |  | Publisher:Stanford University Press ISBN:9780804760126,0,0,2,0,2,2,0,100,0,0,0,0,0
getit.library.nyu.edu/resolve?sid=jstor:jstor&genre=book&title=Dark+Matters&isbn=9780822359197&eisbn=9780822375302,Book | Dark matters on the surveillance of blackness | Browne Simone 2015 |  | Publisher:Duke University Press ISBN:9780822359197,0,0,5,0,5,5,0,100,0,0,0,0,0
getit.library.nyu.edu/resolve?sid=jstor:jstor&genre=book&title=Doing+Gender+in+Heavy+Metal&isbn=9781839981333&eisbn=9781839981340,Book | Doing gender in heavy metal perceptions on women in a hypermasculine subculture | Rogers Anna S 2022 |  | Publisher:Anthem Press ISBN:9781839981333,0,0,1,0,1,1,0,100,0,0,0,0,0
getit.library.nyu.edu/resolve?sid=jstor:jstor&genre=book&title=Everyday+Forms+of+State+Formation&isbn=9780822314523&eisbn=9780822396666,Book | Everyday forms of state formation revolution and the negotiation of rule in modern Mexico | Joseph Gilbert Michael 1994 |  | Publisher:Duke University Press ISBN:9780822314523,0,0,4,0,4,4,0,100,0,0,0,0,0
getit.library.nyu.edu/resolve?sid=jstor:jstor&genre=book&title=Freedom+Time&isbn=9780822358398&eisbn=9780822375791,Book | Freedom time Negritude decolonization and the future of the world | Wilder Gary 2015 |  | Publisher:Duke University Press Books ISBN:9780822358398,0,0,4,0,4,4,0,100,0,0,0,0,0
getit.library.nyu.edu/resolve?sid=jstor:jstor&genre=book&title=Mediality+in+the+Middle+Ages&isbn=9781641890755&eisbn=9781641890762,Book | Mediality in the Middle Ages abundance and lack | Kiening Christian 2019 |  | Publisher:Arc Humanities Press ISBN:9781641890755,0,0,5,0,5,5,0,100,0,0,0,0,0
getit.library.nyu.edu/resolve?sid=jstor:jstor&genre=book&title=Modern+Chinese+Literary+and+Cultural+Studies+in+the+Age+of+Theory&isbn=9780822325840&eisbn=9780822380160,Book | Modern Chinese Literary and Cultural Studies in the Age of Theory Reimagining a Field | Chow Rey 2001 |  | Publisher:Duke University Press ISBN:9780822325840,0,0,4,0,4,4,0,100,0,0,0,0,0
getit.library.nyu.edu/resolve?sid=jstor:jstor&genre=book&title=Moral+Love+Songs+and+Laments&isbn=9781879288973&eisbn=9781580444736,Book | Moral love songs and laments | Susanna Greer Fein 1998 |  | Publisher:Published for TEAMS in association with the University of Rochester by Medieval Institute Publications Western Michigan University ISBN:9781879288973,0,0,1,0,1,1,0,100,0,0,0,0,0
getit.library.nyu.edu/resolve?sid=jstor:jstor&genre=book&title=Notes+on+Social+Measurement&isbn=9780871542199&eisbn=9781610441650,Book | Notes on social measurement historical and critical | Duncan Otis Dudley 1984 |  | Publisher:Russell Sage Foundation ISBN:9780871542199,0,0,2,0,2,2,0,100,0,0,0,0,0
getit.library.nyu.edu/resolve?sid=jstor:jstor&genre=book&title=Recursive+Methods+in+Economic+Dynamics&isbn=9780674750968&eisbn=9780674735187,Book | Recursive methods in economic dynamics | Stokey Nancy L 1989 |  | Publisher:Harvard University Press ISBN:9780674750968,0,0,2,0,2,2,0,100,0,0,0,0,0
getit.library.nyu.edu/resolve?sid=jstor:jstor&genre=book&title=Reggaeton&isbn=9780822343608&eisbn=9780822392323,Book | Reggaeton | Raquel Z Rivera 2009 |  | Publisher:Duke University Press ISBN:9780822343608,0,0,4,0,4,4,0,100,0,0,0,0,0
getit.library.nyu.edu/resolve?sid=jstor:jstor&genre=book&title=Sonic+Experience&isbn=9780773525481&eisbn=9780773576919,Book | Sonic experience a guide to everyday sounds | Jean François Augoyard 2006 |  | Publisher:McGill-Queen's University Press ISBN:9780773525481,0,0,4,0,4,4,0,100,0,0,0,0,0
getit.library.nyu.edu/resolve?sid=jstor:jstor&genre=book&title=The+Crisis+of+Connection&isbn=9781479802784&eisbn=9781479880171,Book | The crisis of connection roots consequences and solutions | Way Niobe 2018 |  | Publisher:NYU Press ISBN:9781479802784,0,0,4,0,4,4,0,100,0,0,0,0,0
getit.library.nyu.edu/resolve?sid=jstor:jstor&genre=book&title=The+Market+for+Mesoamerica&isbn=9780813056449&eisbn=9780813057200,Book | The market for Mesoamerica reflections on the sale of pre-Columbian antiquities | Cara G Tremain 2019 |  | Publisher:University Press of Florida ISBN:9780813056449,0,0,2,0,2,2,0,100,0,0,0,0,0
getit.library.nyu.edu/resolve?sid=jstor:jstor&genre=book&title=The+Rosetta+Stone+and+the+Rebirth+of+Ancient+Egypt&isbn=9780674024939&eisbn=9780674063648,Book | The Rosetta Stone and the rebirth of ancient Egypt | Ray J D 2007 |  | Publisher:Harvard University Press ISBN:9780674024939,0,0,2,0,2,2,0,100,0,0,0,0,0
getit.library.nyu.edu/resolve?sid=jstor:jstor&genre=book&title=Wandering&isbn=9780822357155&eisbn=9780822376347,Book | Wandering philosophical performances of racial and sexual freedom | Cervenak Sarah Jane 2014 |  | Publisher:Duke University Press Books ISBN:9780822357155,0,0,5,0,5,5,0,100,0,0,0,0,0
getit.library.nyu.edu/resolve?sid=literatum:tandf&aulast=Li&aufirst=Y.&date=2013&atitle=Gongzhong dui tongxinglian de taidu ji iingxiang yinsu [Public attitudes toward homosexuality and its predictors]&jtitle=Journal of South China Normal University (Social Science Edition)&volume=6&spage=31&epage=36,Article | Gongzhong dui tongxinglian de taidu ji iingxiang yinsu Public attitudes toward homosexuality and its predictors] | Li Y 2013 | Published in Journal Volume 6 Page 31 36. | ISSN:1000-5455,0,0,1,0,1,1,0,100,0,0,0,0,0
getit.library.nyu.edu/resolve?sid=wdg:ibr&genre=article&issn=0021-8758&title=Journal+of+American+Studies&atitle=A+war+for+the+soul+of+America.+A+history+of+the+culture+wars&volume=51&issue=2&pages=629-630&date=2017&aulast=Hartman&aufirst=Andrew,Article | A war for the soul of America A history of the culture wars | Hartman Andrew 2017 | Published in Journal Journal of American Studies Volume 51 Issue 2 Page 629 630. | ISSN:0021-8758,4,2,1,6,5,11,55,45,0,0,0,0,0
"getit.library.nyu.edu/resolve?umlaut.institution=NYU&umlaut.referent_id=18508455&url_ver=Z39.88-2004&url_ctx_fmt=info:ofi/fmt:kev:mtx:ctx&ctx_ver=Z39.88-2004&ctx_tim=2021-07-13T12:03:24-04:00&ctx_id=&ctx_enc=info:ofi/enc:UTF-8&rft.au=Esselink,+Bert&rft.aucorp=O'Brien,+Shiera&rft.aufirst=Bert.&rft.aulast=Esselink&rft.btitle=A+Practical+guide+to+localization&rft.date=2000&rft.eisbn=1-283-31486-X&rft.eisbn_additional=9786613314864&rft.eissn=1588110060&rft.genre=book&rft.isbn=1588110052&rft.isbn_additional=978-90-272-1955-8&rft.language=eng&rft.object_id=1000000000008826&rft.oclcnum=70737067&rft.place=Amsterdam+;+Philadelphia&rft.primo=nyu_aleph003194714&rft.private_data=<nyu_aleph>003194714</nyu_aleph><grp_id>536744250</grp_id><oa></oa><url></url>&rft.pub=John+Benjamins+Pub.+Co.&rft.stitle=PRACTICAL+GUIDE+TO+LOCALIZATION&rft.title=A+Practical+guide+to+localization&rft.tpages=488&rft_val_fmt=info:ofi/fmt:kev:mtx:book&rfr_id=info:sid/primo.exlibrisgroup.com:primo-nyu_aleph003194714",Book | A Practical guide to localization | Esselink Bert 2000 |  | Publisher:John Benjamins Pub Co ISBN:1588110052,0,0,4,0,4,4,0,100,0,0,0,0,0
"getit.library.nyu.edu/resolve?umlaut.institution=NYU&umlaut.referent_id=18619539&url_ver=Z39.88-2004&url_ctx_fmt=info:ofi/fmt:kev:mtx:ctx&ctx_ver=Z39.88-2004&ctx_tim=2021-10-11T14:48:22-04:00&ctx_id=&ctx_enc=info:ofi/enc:UTF-8&rft.genre=journal&rft.issn=1082-8354&rft.jtitle=Race,+Gender+&+Class=&rft.language=eng&rft.lccn=sn+95001107+&rft.object_id=110978984251400&rft.place=Towson,+MD&rft.pub=Jean+Ait+Belkhir,+Race,+Gender+&+Class+Journal=&rft.stitle=RACE+GENDER+AND+CLASS+AN+INTERDISCIPLINARY+JOURNAL&rft.title=Race,+Gender+&+Class=&rft_val_fmt=info:ofi/fmt:kev:mtx:journal&rfr_id=info:sid/sfxit.com:citation",Journal | Race Gender |  | ISSN:1082-8354 | undefined,4,2,1,6,5,11,55,45,0,0,0,0,0
"getit.library.nyu.edu/resolve?umlaut.institution=NYU&umlaut.referent_id=18749471&url_ver=Z39.88-2004&url_ctx_fmt=info:ofi/fmt:kev:mtx:ctx&ctx_ver=Z39.88-2004&ctx_tim=2021-12-10T18:38:45-05:00&ctx_id=&ctx_enc=info:ofi/enc:UTF-8&rft.btitle=Computer-aided+translation+technology+:+a+practical+introduction&rft.date=2002&rft.eisbn=0-7766-3016-4&rft.eisbn_additional=978-0-7766-1567-7&rft.genre=book&rft.isbn=9780776615677&rft.language=eng&rft.lccn=2002437124&rft.object_id=2430000000000674&rft.oclcnum=181843536&rft.place=Ottawa+[Ont.]&rft.primo=dedupmrg494620255&rft.private_data=<nyu_aleph>005803711</nyu_aleph><grp_id>552848017</grp_id><oa></oa><url></url>&rft.pub=University+of+Ottawa+Press&rft.stitle=COMPUTER-AIDED+TRANSLATION+TECHNOLOGY&rft.title=Computer-aided+translation+technology+:+a+practical+introduction&rft.tpages=220&rft.au=Bowker,+Lynne,+1969-&rft.aulast=Bowker&rft.aufirst=Lynne,&rft_val_fmt=info:ofi/fmt:kev:mtx:book&rfr_id=info:sid/primo.exlibrisgroup.com:primo-dedupmrg494620255",Book | Computer-aided translation technology a practical introduction | Bowker Lynne 2002 |  | Publisher:University of Ottawa Press ISBN:9780776615677,0,0,4,0,4,4,0,100,0,0,0,0,0
"getit.library.nyu.edu/resolve?umlaut.institution=NYU&umlaut.referent_id=18935185&url_ver=Z39.88-2004&url_ctx_fmt=info:ofi/fmt:kev:mtx:ctx&ctx_ver=Z39.88-2004&ctx_tim=2022-04-14T11:42:21-04:00&ctx_id=&ctx_enc=info:ofi/enc:UTF-8&rft.au=Mumford,+Lewis&rft.aucorp=Fisher,+Thomas&rft.aufirst=Lewis,&rft.aulast=Mumford&rft.btitle=The+Culture+of+Cities.&rft.date=2016&rft.eisbn=1-5040-3134-2&rft.genre=book&rft.isbn=9781504031349&rft.language=eng&rft.object_id=3710000000577509&rft.oclcnum=968007872&rft.primo=nyu_aleph006264275&rft.private_data=<nyu_aleph>006264275</nyu_aleph><grp_id>658670625</grp_id><oa></oa><url></url>&rft.pub=Open+Road+Media&rft.title=The+Culture+of+Cities.&rft.tpages=640&rft_val_fmt=info:ofi/fmt:kev:mtx:book&rfr_id=info:sid/primo.exlibrisgroup.com:primo-nyu_aleph006264275",Book | The Culture of Cities. | Mumford Lewis 2016 |  | Publisher:Open Road Media ISBN:9781504031349,0,0,3,0,3,3,0,100,0,0,0,0,0
"getit.library.nyu.edu/resolve?umlaut.institution=NYU&umlaut.referent_id=18941378&url_ver=Z39.88-2004&url_ctx_fmt=info:ofi/fmt:kev:mtx:ctx&ctx_ver=Z39.88-2004&ctx_tim=2022-04-17T09:40:35-04:00&ctx_id=&ctx_enc=info:ofi/enc:UTF-8&rft.au=Mumford,+Eric+Paul&rft.aufirst=Eric+Paul,&rft.auinitm=P&rft.aulast=Mumford&rft.btitle=Designing+the+modern+city+:+urbanism+since+1850&rft.date=2018&rft.eisbn=0-300-23039-7&rft.eisbn_additional=978-0-300-23039-0&rft.genre=book&rft.isbn=9780300207729&rft.language=eng&rft.lccn=2017939210&rft.object_id=4100000004837667&rft.oclcnum=1032304958&rft.primo=dedupmrg591024435&rft.private_data=<nyu_aleph>007395764</nyu_aleph><grp_id>648918506</grp_id><oa></oa><url></url>&rft.pub=Yale+University+Press&rft.title=Designing+the+modern+city+:+urbanism+since+1850&rft.tpages=360&rft_val_fmt=info:ofi/fmt:kev:mtx:book&rfr_id=info:sid/primo.exlibrisgroup.com:primo-dedupmrg591024435",Book | Designing the modern city urbanism since 1850 | Mumford Eric Paul 2018 |  | Publisher:Yale University Press ISBN:9780300207729,0,0,7,0,7,7,0,100,0,0,0,0,0
"getit.library.nyu.edu/resolve?umlaut.institution=NYU&umlaut.referent_id=18941378&url_ver=Z39.88-2004&url_ctx_fmt=info:ofi/fmt:kev:mtx:ctx&ctx_ver=Z39.88-2004&ctx_tim=2022-04-17T19:35:08-04:00&ctx_id=&ctx_enc=info:ofi/enc:UTF-8&rft.au=Mumford,+Eric+Paul&rft.aufirst=Eric+Paul,&rft.auinitm=P&rft.aulast=Mumford&rft.btitle=Designing+the+modern+city+:+urbanism+since+1850&rft.date=2018&rft.eisbn=0-300-23039-7&rft.eisbn_additional=978-0-300-23039-0&rft.genre=book&rft.isbn=9780300207729&rft.language=eng&rft.lccn=2017939210&rft.object_id=4100000004837667&rft.oclcnum=1032304958&rft.primo=dedupmrg591024435&rft.private_data=<nyu_aleph>007395764</nyu_aleph><grp_id>648918506</grp_id><oa></oa><url></url>&rft.pub=Yale+University+Press&rft.title=Designing+the+modern+city+:+urbanism+since+1850&rft.tpages=360&rft_val_fmt=info:ofi/fmt:kev:mtx:book&rfr_id=info:sid/primo.exlibrisgroup.com:primo-dedupmrg591024435",Book | Designing the modern city urbanism since 1850 | Mumford Eric Paul 2018 |  | Publisher:Yale University Press ISBN:9780300207729,0,0,7,0,7,7,0,100,0,0,0,0,0
"getit.library.nyu.edu/resolve?umlaut.institution=NYU&umlaut.referent_id=18941380&url_ver=Z39.88-2004&url_ctx_fmt=info:ofi/fmt:kev:mtx:ctx&ctx_ver=Z39.88-2004&ctx_tim=2022-04-16T20:48:38-04:00&ctx_id=&ctx_enc=info:ofi/enc:UTF-8&rft.btitle=Tower+and+Slab+:+Histories+of+Global+Mass+Housing.&rft.date=2011&rft.eisbn=0-203-80413-9&rft.eisbn_additional=9786613443304&rft.genre=book&rft.isbn=9780203804131&rft.isbn_additional=978-0-415-67629-8&rft.language=eng&rft.object_id=2550000000089010&rft.oclcnum=798530612&rft.place=Hoboken&rft.primo=nyu_aleph003816633&rft.private_data=<nyu_aleph>003816633</nyu_aleph><grp_id>655084253</grp_id><oa></oa><url></url>&rft.pub=Taylor+&+Francis=&rft.title=Tower+and+Slab+:+Histories+of+Global+Mass+Housing.&rft.au=Urban,+Florian&rft.aulast=Urban&rft.aufirst=Florian.&rft_val_fmt=info:ofi/fmt:kev:mtx:book&rfr_id=info:sid/primo.exlibrisgroup.com:primo-nyu_aleph003816633",Book | Tower and Slab Histories of Global Mass Housing. | Urban Florian 2011 |  | Publisher:Taylor Francis ISBN:9780203804131,0,0,1,0,1,1,0,100,0,0,0,0,0
"getit.library.nyu.edu/resolve?umlaut.institution=NYU&umlaut.referent_id=18941736&url_ver=Z39.88-2004&url_ctx_fmt=info:ofi/fmt:kev:mtx:ctx&ctx_ver=Z39.88-2004&ctx_tim=2022-04-17T09:39:22-04:00&ctx_id=&ctx_enc=info:ofi/enc:UTF-8&rft.au=Peterson,+Jon+A&rft.aufirst=Jon+A.&rft.auinitm=A&rft.aulast=Peterson&rft.btitle=The+birth+of+city+planning+in+the+United+States,+1840-1917&rft.date=2003&rft.genre=book&rft.isbn=0801872103&rft.language=eng&rft.lccn=2002009870&rft.object_id=1000000000548203&rft.oclcnum=298104977&rft.place=Baltimore&rft.primo=dedupmrg492217664&rft.private_data=<nyu_aleph>000971724</nyu_aleph><grp_id>553132686</grp_id><oa></oa><url></url>&rft.pub=Johns+Hopkins+University+Press&rft.stitle=BIRTH+OF+CITY+PLANNING+IN+THE+UNITED+STATES,+1840-1917&rft.title=The+birth+of+city+planning+in+the+United+States,+1840-1917&rft.tpages=431&rft_val_fmt=info:ofi/fmt:kev:mtx:book&rfr_id=info:sid/primo.exlibrisgroup.com:primo-dedupmrg492217664",Book | The birth of city planning in the United States 1840-1917 | Peterson Jon A 2003 |  | Publisher:Johns Hopkins University Press ISBN:0801872103,1,0,3,1,4,5,20,80,0,0,0,0,0
"getit.library.nyu.edu/resolve?umlaut.institution=NYU&umlaut.referent_id=18941736&url_ver=Z39.88-2004&url_ctx_fmt=info:ofi/fmt:kev:mtx:ctx&ctx_ver=Z39.88-2004&ctx_tim=2022-04-20T10:41:41-04:00&ctx_id=&ctx_enc=info:ofi/enc:UTF-8&rft.au=Peterson,+Jon+A&rft.aufirst=Jon+A.&rft.auinitm=A&rft.aulast=Peterson&rft.btitle=The+birth+of+city+planning+in+the+United+States,+1840-1917&rft.date=2003&rft.genre=book&rft.isbn=0801872103&rft.language=eng&rft.lccn=2002009870&rft.object_id=1000000000548203&rft.oclcnum=298104977&rft.place=Baltimore&rft.primo=dedupmrg492217664&rft.private_data=<nyu_aleph>000971724</nyu_aleph><grp_id>553132686</grp_id><oa></oa><url></url>&rft.pub=Johns+Hopkins+University+Press&rft.stitle=BIRTH+OF+CITY+PLANNING+IN+THE+UNITED+STATES,+1840-1917&rft.title=The+birth+of+city+planning+in+the+United+States,+1840-1917&rft.tpages=431&rft_val_fmt=info:ofi/fmt:kev:mtx:book&rfr_id=info:sid/primo.exlibrisgroup.com:primo-dedupmrg492217664",Book | The birth of city planning in the United States 1840-1917 | Peterson Jon A 2003 |  | Publisher:Johns Hopkins University Press ISBN:0801872103,1,0,3,1,4,5,20,80,0,0,0,0,0
"getit.library.nyu.edu/resolve?umlaut.institution=NYU&umlaut.referent_id=18942091&url_ver=Z39.88-2004&url_ctx_fmt=info:ofi/fmt:kev:mtx:ctx&ctx_ver=Z39.88-2004&ctx_tim=2022-04-19T16:08:27-04:00&ctx_id=&ctx_enc=info:ofi/enc:UTF-8&rft.au=Plunz,+Richard&rft.aucorp=Plunz,+Richard;+Jackson,+Kenneth+T.&rft.aufirst=Richard.&rft.aulast=Plunz&rft.btitle=A+History+of+Housing+in+New+York+City&rft.date=2016&rft.eisbn=0-231-54310-7&rft.genre=book&rft.isbn=9780231543101&rft.isbn_additional=978-0-231-17834-1&rft.language=eng&rft.object_id=3710000000865186&rft.oclcnum=984682001&rft.place=La+Vergne&rft.primo=nyu_aleph005353016&rft.private_data=<nyu_aleph>005353016</nyu_aleph><grp_id>537908629</grp_id><oa></oa><url></url>&rft.pub=Columbia+University+Press&rft.title=A+History+of+Housing+in+New+York+City&rft.tpages=496&rft_val_fmt=info:ofi/fmt:kev:mtx:book&rfr_id=info:sid/primo.exlibrisgroup.com:primo-nyu_aleph005353016",Book | A History of Housing in New York City | Plunz Richard 2016 |  | Publisher:Columbia University Press ISBN:9780231543101,0,0,1,0,1,1,0,100,0,0,0,0,0
"getit.library.nyu.edu/resolve?umlaut.institution=NYU&umlaut.referent_id=18947801&url_ver=Z39.88-2004&url_ctx_fmt=info:ofi/fmt:kev:mtx:ctx&ctx_ver=Z39.88-2004&ctx_tim=2022-04-19T22:46:51-04:00&ctx_id=&ctx_enc=info:ofi/enc:UTF-8&rft.au=Foglesong,+Richard+E.&rft.aucorp=Project+Muse&rft.aufirst=Richard+E.,&rft.auinitm=E&rft.aulast=Foglesong&rft.btitle=Planning+the+capitalist+city+:+the+colonial+era+to+the+1920s&rft.date=2014&rft.eisbn=0-691-61061-4&rft.eisbn_additional=978-1-4008-5450-9&rft.eissn=0691077053&rft.genre=book&rft.isbn=9781400854509&rft.isbn_additional=978-1-306-98960-2&rft.language=eng&rft.lccn=85043278&rft.object_id=2550000001333746&rft.oclcnum=888216290&rft.place=Princeton,+N.J.&rft.primo=dedupmrg492192624&rft.private_data=<nyu_aleph>005816337</nyu_aleph><grp_id>553012520</grp_id><oa></oa><url></url>&rft.pub=Princeton+University+Press&rft.title=Planning+the+capitalist+city+:+the+colonial+era+to+the+1920s&rft.tpages=298&rft_val_fmt=info:ofi/fmt:kev:mtx:book&rfr_id=info:sid/primo.exlibrisgroup.com:primo-dedupmrg492192624",Book | Planning the capitalist city the colonial era to the 1920s | Foglesong Richard E 2014 |  | Publisher:Princeton University Press ISBN:9781400854509,0,0,6,0,6,6,0,100,0,0,0,0,0
"getit.library.nyu.edu/resolve?umlaut.institution=NYU&umlaut.referent_id=18981854&url_ver=Z39.88-2004&url_ctx_fmt=info:ofi/fmt:kev:mtx:ctx&ctx_ver=Z39.88-2004&ctx_tim=2022-05-07T15:26:02-04:00&ctx_id=&ctx_enc=info:ofi/enc:UTF-8&rft.au=Mumford,+Eric+Paul,+1958-&rft.aufirst=Eric+Paul,&rft.auinitm=P&rft.aulast=Mumford&rft.btitle=Designing+the+modern+city+:+urbanism+since+1850&rft.date=2018&rft.eisbn=0-300-23039-7&rft.genre=book&rft.isbn=9780300207729&rft.language=eng&rft.lccn=2017939210&rft.object_id=4100000004837667&rft.oclcnum=1032304958&rft.primo=dedupmrg591024435&rft.private_data=<nyu_aleph>007395764</nyu_aleph><grp_id>648918506</grp_id><oa></oa><url></url>&rft.pub=Yale+University+Press&rft.title=Designing+the+modern+city+:+urbanism+since+1850&rft.tpages=360&rft_val_fmt=info:ofi/fmt:kev:mtx:book&rfr_id=info:sid/primo.exlibrisgroup.com:primo-dedupmrg591024435",Book | Designing the modern city urbanism since 1850 | Mumford Eric Paul 2018 |  | Publisher:Yale University Press ISBN:9780300207729,0,0,7,0,7,7,0,100,0,0,0,0,0
"getit.library.nyu.edu/resolve?umlaut.institution=NYU&umlaut.referent_id=18986315&url_ver=Z39.88-2004&url_ctx_fmt=info:ofi/fmt:kev:mtx:ctx&ctx_ver=Z39.88-2004&ctx_tim=2022-05-10T21:01:59-04:00&ctx_id=&ctx_enc=info:ofi/enc:UTF-8&rft.au=Mumford,+Eric+Paul&rft.aufirst=Eric+Paul,&rft.auinitm=P&rft.aulast=Mumford&rft.btitle=Designing+the+modern+city+:+urbanism+since+1850&rft.date=2018&rft.eisbn=0-300-23039-7&rft.eisbn_additional=978-0-300-23039-0&rft.genre=book&rft.isbn=9780300207729&rft.language=eng&rft.lccn=2017939210&rft.object_id=4100000004837667&rft.oclcnum=1032304958&rft.primo=dedupmrg591024435&rft.private_data=<nyu_aleph>007395764</nyu_aleph><grp_id>648918506</grp_id><oa></oa><url></url>&rft.pub=Yale+University+Press&rft.title=Designing+the+modern+city+:+urbanism+since+1850&rft.tpages=360&rft_val_fmt=info:ofi/fmt:kev:mtx:book&rfr_id=info:sid/primo.exlibrisgroup.com:primo-dedupmrg591024435",Book | Designing the modern city urbanism since 1850 | Mumford Eric Paul 2018 |  | Publisher:Yale University Press ISBN:9780300207729,0,0,7,0,7,7,0,100,0,0,0,0,0
"getit.library.nyu.edu/resolve?umlaut.institution=NYU&umlaut.referent_id=18992234&url_ver=Z39.88-2004&url_ctx_fmt=info:ofi/fmt:kev:mtx:ctx&ctx_ver=Z39.88-2004&ctx_tim=2022-05-14T15:02:52-04:00&ctx_id=&ctx_enc=info:ofi/enc:UTF-8&rft.au=Mumford,+Eric+Paul&rft.aufirst=Eric+Paul,&rft.auinitm=P&rft.aulast=Mumford&rft.btitle=Designing+the+modern+city+:+urbanism+since+1850&rft.date=2018&rft.eisbn=0-300-23039-7&rft.eisbn_additional=978-0-300-23039-0&rft.genre=book&rft.isbn=9780300207729&rft.language=eng&rft.lccn=2017939210&rft.object_id=4100000004837667&rft.oclcnum=1032304958&rft.primo=dedupmrg591024435&rft.private_data=<nyu_aleph>007395764</nyu_aleph><grp_id>648918506</grp_id><oa></oa><url></url>&rft.pub=Yale+University+Press&rft.title=Designing+the+modern+city+:+urbanism+since+1850&rft.tpages=360&rft_val_fmt=info:ofi/fmt:kev:mtx:book&rfr_id=info:sid/primo.exlibrisgroup.com:primo-dedupmrg591024435",Book | Designing the modern city urbanism since 1850 | Mumford Eric Paul 2018 |  | Publisher:Yale University Press ISBN:9780300207729,0,0,7,0,7,7,0,100,0,0,0,0,0
"getit.library.nyu.edu/resolve?umlaut.institution=NYU&umlaut.referent_id=18992234&url_ver=Z39.88-2004&url_ctx_fmt=info:ofi/fmt:kev:mtx:ctx&ctx_ver=Z39.88-2004&ctx_tim=2022-05-17T20:43:16-04:00&ctx_id=&ctx_enc=info:ofi/enc:UTF-8&rft.au=Mumford,+Eric+Paul&rft.aufirst=Eric+Paul,&rft.auinitm=P&rft.aulast=Mumford&rft.btitle=Designing+the+modern+city+:+urbanism+since+1850&rft.date=2018&rft.eisbn=0-300-23039-7&rft.eisbn_additional=978-0-300-23039-0&rft.genre=book&rft.isbn=9780300207729&rft.language=eng&rft.lccn=2017939210&rft.object_id=4100000004837667&rft.oclcnum=1032304958&rft.primo=dedupmrg591024435&rft.private_data=<nyu_aleph>007395764</nyu_aleph><grp_id>648918506</grp_id><oa></oa><url></url>&rft.pub=Yale+University+Press&rft.title=Designing+the+modern+city+:+urbanism+since+1850&rft.tpages=360&rft_val_fmt=info:ofi/fmt:kev:mtx:book&rfr_id=info:sid/primo.exlibrisgroup.com:primo-dedupmrg591024435",Book | Designing the modern city urbanism since 1850 | Mumford Eric Paul 2018 |  | Publisher:Yale University Press ISBN:9780300207729,0,0,7,0,7,7,0,100,0,0,0,0,0
"getit.library.nyu.edu/resolve?umlaut.institution=NYU&url_ver=Z39.88-2004&url_ctx_fmt=info:ofi/fmt:kev:mtx:ctx&ctx_ver=Z39.88-2004&ctx_tim=2022-02-19T19:31:51-05:00&ctx_id=&ctx_enc=info:ofi/enc:UTF-8&rft.au=Stewart,+William+Rhinelander&rft.aufirst=William+Rhinelander,&rft.aulast=Stewart&rft.btitle=Grace+church+and+old+New+York&rft.genre=book&rft.lccn=24008510&rft.oclcnum=1526938&rft.place=New+York&rft.primo=nyu_aleph002186917&rft.private_data=<nyu_aleph>002186917</nyu_aleph><grp_id>1146946392</grp_id><oa></oa><url></url>&rft.pub=E.+P.+Dutton+&+Company=&rft.title=Grace+church+and+old+New+York&rft_val_fmt=info:ofi/fmt:kev:mtx:book&req.ip=141.149.32.249&rfr_id=info:sid/primo.exlibrisgroup.com:primo-nyu_aleph002186917",Book | Grace church and old New York | Stewart William Rhinelander |  | Publisher:E P Dutton Company,0,0,2,0,2,2,0,100,0,0,0,0,0
"getit.library.nyu.edu/resolve?umlaut.institution=NYUAD&umlaut.referent_id=18559103&url_ver=Z39.88-2004&url_ctx_fmt=info:ofi/fmt:kev:mtx:ctx&ctx_ver=Z39.88-2004&ctx_tim=2021-09-07T12:36:02-04:00&ctx_id=&ctx_enc=info:ofi/enc:UTF-8&rft.au=Loeb,+James&rft.aufirst=James,&rft.aulast=Loeb&rft.btitle=Loeb+classical+library&rft.genre=database&rft.lccn=2014228665&rft.oclcnum=890330258&rft.title=Loeb+classical+library&rft_val_fmt=info:ofi/fmt:kev:mtx:database&rfr_id=info:sid/primo.exlibrisgroup.com:primo-nyu_aleph006248817",Loeb classical library | Loeb James |  |  | undefined,0,0,1,0,1,1,0,100,0,1,0,0,0
"getit.library.nyu.edu/resolve?umlaut.institution=NYUAD&umlaut.referent_id=18559103&url_ver=Z39.88-2004&url_ctx_fmt=info:ofi/fmt:kev:mtx:ctx&ctx_ver=Z39.88-2004&ctx_tim=2021-09-07T13:17:57-04:00&ctx_id=&ctx_enc=info:ofi/enc:UTF-8&rft.au=Loeb,+James&rft.aufirst=James,&rft.aulast=Loeb&rft.btitle=Loeb+classical+library&rft.genre=database&rft.lccn=2014228665&rft.oclcnum=890330258&rft.title=Loeb+classical+library&rft_val_fmt=info:ofi/fmt:kev:mtx:database&rfr_id=info:sid/primo.exlibrisgroup.com:primo-nyu_aleph006248817",Loeb classical library | Loeb James |  |  | undefined,0,0,1,0,1,1,0,100,0,1,0,0,0
"getit.library.nyu.edu/resolve?umlaut.institution=NYUAD&umlaut.referent_id=18564559&url_ver=Z39.88-2004&url_ctx_fmt=info:ofi/fmt:kev:mtx:ctx&ctx_ver=Z39.88-2004&ctx_tim=2021-09-14T16:24:52-04:00&ctx_id=&ctx_enc=info:ofi/enc:UTF-8&rft.au=Loeb,+James&rft.aufirst=James,&rft.aulast=Loeb&rft.btitle=Loeb+classical+library&rft.genre=database&rft.lccn=2014228665&rft.oclcnum=890330258&rft.title=Loeb+classical+library&rft_val_fmt=info:ofi/fmt:kev:mtx:database&rfr_id=info:sid/primo.exlibrisgroup.com:primo-nyu_aleph006248817",Loeb classical library | Loeb James |  |  | undefined,0,0,1,0,1,1,0,100,0,1,0,0,0
"getit.library.nyu.edu/resolve?umlaut.institution=NYUAD&umlaut.referent_id=18607407&url_ver=Z39.88-2004&url_ctx_fmt=info:ofi/fmt:kev:mtx:ctx&ctx_ver=Z39.88-2004&ctx_tim=2021-10-06T13:22:24-04:00&ctx_id=&ctx_enc=info:ofi/enc:UTF-8&rft.au=Loeb,+James&rft.aufirst=James,&rft.aulast=Loeb&rft.btitle=Loeb+classical+library&rft.genre=database&rft.lccn=2014228665&rft.oclcnum=890330258&rft.title=Loeb+classical+library&rft_val_fmt=info:ofi/fmt:kev:mtx:database&rfr_id=info:sid/primo.exlibrisgroup.com:primo-nyu_aleph006248817",Loeb classical library | Loeb James |  |  | undefined,0,0,1,0,1,1,0,100,0,1,0,0,0
"getit.library.nyu.edu/resolve?umlaut.institution=NYUAD&umlaut.referent_id=18673548&url_ver=Z39.88-2004&url_ctx_fmt=info:ofi/fmt:kev:mtx:ctx&ctx_ver=Z39.88-2004&ctx_tim=2021-11-07T03:09:32-05:00&ctx_id=&ctx_enc=info:ofi/enc:UTF-8&rft.au=Carey,+John+M&rft.aufirst=John+M.&rft.auinitm=M&rft.aulast=Carey&rft.btitle=Legislative+voting+and+accountability&rft.date=2009&rft.eisbn=1-107-20041-5&rft.eisbn_additional=978-1-282-00163-3&rft.genre=book&rft.isbn=9780521884938&rft.isbn_additional=978-0-521-71191-3&rft.language=eng&rft.lccn=2008019287&rft.object_id=1000000000702649&rft.oclcnum=227205766&rft.place=Cambridge+;+New+York&rft.primo=dedupmrg11738512&rft.pub=Cambridge+University+Press&rft.stitle=LEGISLATIVE+VOTING+&+ACCOUNTABILITY=&rft.title=Legislative+voting+and+accountability&rft.tpages=216&rft_val_fmt=info:ofi/fmt:kev:mtx:book&rfr_id=info:sid/primo.exlibrisgroup.com:primo-dedupmrg11738512",Book | Legislative voting and accountability | Carey John M 2009 |  | Publisher:Cambridge University Press ISBN:9780521884938,0,0,2,0,2,2,0,100,0,0,0,0,0
"getit.library.nyu.edu/resolve?umlaut.institution=NYUAD&umlaut.referent_id=18798566&url_ver=Z39.88-2004&url_ctx_fmt=info:ofi/fmt:kev:mtx:ctx&ctx_ver=Z39.88-2004&ctx_tim=2022-01-26T12:25:35-05:00&ctx_id=&ctx_enc=info:ofi/enc:UTF-8&rft.au=Rettberg,+Jill+Walker&rft.aufirst=Jill+Walker,&rft.auinitm=W&rft.aulast=Rettberg&rft.btitle=Seeing+ourselves+through+technology+:+how+we+use+selfies,+blogs+and+wearable+devices+to+see+and+shape+ourselves&rft.date=2016&rft.eissn=9781137476647&rft.genre=book&rft.isbn=9781137476661&rft.isbn_additional=978-1-349-99539-4&rft.language=eng&rft.object_id=3280000000039137&rft.oclcnum=892563828&rft.place=Cham&rft.primo=dedupmrg491663416&rft.private_data=<nyu_aleph>006560384</nyu_aleph><grp_id>552969670</grp_id><oa></oa><url></url>&rft.pub=Palgrave+Macmillan+UK&rft.title=Seeing+ourselves+through+technology+:+how+we+use+selfies,+blogs+and+wearable+devices+to+see+and+shape+ourselves&rft.tpages=101&rft_val_fmt=info:ofi/fmt:kev:mtx:book&rfr_id=info:sid/primo.exlibrisgroup.com:primo-dedupmrg491663416",Book | Seeing Ourselves Through Technology How We Use Selfies Blogs and Wearable Devices to See and Shape Ourselves | Rettberg Jill Walker 2016 |  | Publisher:Palgrave Macmillan UK ISBN:9781137476661,0,0,8,0,8,8,0,100,0,0,0,0,0
"getit.library.nyu.edu/resolve?umlaut.institution=NYUAD&umlaut.referent_id=18941595&url_ver=Z39.88-2004&url_ctx_fmt=info:ofi/fmt:kev:mtx:ctx&ctx_ver=Z39.88-2004&ctx_tim=2022-04-17T02:47:23-04:00&ctx_id=&ctx_enc=info:ofi/enc:UTF-8&rft.au=David+Chandler&rft.aufirst=David.&rft.auinitm=H&rft.aulast=Chandler&rft.btitle=Rethinking+ethical+foreign+policy+:+pitfalls,+possibilities+and+paradoxes&rft.date=2007&rft.eisbn=9786610648450&rft.eisbn_additional=1-134-14711-2&rft.genre=book&rft.isbn=0415400198&rft.isbn_additional=1-138-98535-X&rft.language=eng&rft.lccn=2006016002&rft.object_id=1000000000404693&rft.oclcnum=69331427&rft.place=London&rft.primo=dedupmrg50181724&rft.private_data=<nyu_aleph>003867191</nyu_aleph><grp_id>52611002</grp_id><oa></oa>&rft.pub=Routledge&rft.stitle=RETHINKING+ETHICAL+FOREIGN+POLICY&rft.title=Rethinking+ethical+foreign+policy+:+pitfalls,+possibilities+and+paradoxes&rft.tpages=244&rft_val_fmt=info:ofi/fmt:kev:mtx:book&rfr_id=info:sid/primo.exlibrisgroup.com:primo-dedupmrg50181724",Book | Rethinking ethical foreign policy pitfalls possibilities and paradoxes | David Chandler 2007 |  | Publisher:Routledge ISBN:0415400198,0,0,1,0,1,1,0,100,0,0,0,0,0
"getit.library.nyu.edu/resolve?umlaut.institution=NYUSH&umlaut.referent_id=18539378&url_ver=Z39.88-2004&url_ctx_fmt=info:ofi/fmt:kev:mtx:ctx&ctx_ver=Z39.88-2004&ctx_tim=2021-08-16T10:35:33-04:00&ctx_id=&ctx_enc=info:ofi/enc:UTF-8&rft.btitle=Introduction+to+scientific+publishing+backgrounds,+concepts,+strategies&rft.date=2013&rft.eisbn=3-642-38646-6&rft.eissn=9783642386459&rft.genre=book&rft.isbn=9783642386466&rft.language=eng&rft.object_id=2670000000403416&rft.oclcnum=852954904&rft.place=Berlin+;+New+York&rft.primo=nyu_aleph004423436&rft.private_data=<nyu_aleph>004423436</nyu_aleph><grp_id>399503488</grp_id><oa></oa>&rft.pub=Springer&rft.title=Introduction+to+scientific+publishing+backgrounds,+concepts,+strategies&rft.au=O\u0308chsner,+Andreas&rft.aulast=O\u0308chsner&rft.aufirst=Andreas.&rft_val_fmt=info:ofi/fmt:kev:mtx:book&rfr_id=info:sid/primo.exlibrisgroup.com:primo-nyu_aleph004423436",Book | Introduction to scientific publishing backgrounds concepts strategies | Öchsner Andreas 2013 |  | Publisher:Springer ISBN:9783642386466,0,0,3,0,3,3,0,100,0,0,0,0,0
getit.library.nyu.edu/resolve?umlaut.referent_id=18462799&url_ver=Z39.88-2004&url_ctx_fmt=info:ofi/fmt:kev:mtx:ctx&ctx_ver=Z39.88-2004&ctx_tim=2021-06-01T11:48:33-04:00&ctx_id=&ctx_enc=info:ofi/enc:UTF-8&rft.jtitle=Journal+for+Islamic+Studies&rft_val_fmt=info:ofi/fmt:kev:mtx:journal&rfr_id=info:sid/umlaut.code4lib.org:opensearch,Journal | Journal for Islamic studies |  | ISSN:0257-7062 | undefined,1,0,3,1,4,5,20,80,0,0,0,0,0
"getit.library.nyu.edu/resolve?umlaut.referent_id=18463611&url_ver=Z39.88-2004&url_ctx_fmt=info:ofi/fmt:kev:mtx:ctx&ctx_ver=Z39.88-2004&ctx_tim=2021-06-01T23:42:42-04:00&ctx_id=&ctx_enc=info:ofi/enc:UTF-8&rft.btitle=A+first+course+in+the+numerical+analysis+of+differential+equations&rft.date=2009&rft.eisbn=1-139-13490-6&rft.eisbn_additional=9786613330390&rft.eissn=9780521734905&rft.genre=book&rft.isbn=9780521734905&rft.isbn_additional=978-1-139-63656-8&rft.language=eng&rft.lccn=2009285762&rft.object_id=1000000000719115&rft.oclcnum=320895922&rft.place=Cambridge+;+New+York&rft.primo=dedupmrg490532093&rft.private_data=<nyu_aleph>003777474</nyu_aleph><grp_id>552689416</grp_id><oa></oa><url></url>&rft.pub=Cambridge+University+Press&rft.stitle=FIRST+COURSE+IN+THE+NUMERICAL+ANALYSIS+OF+DIFFERENTIAL+EQUATIONS&rft.title=A+first+course+in+the+numerical+analysis+of+differential+equations&rft.tpages=459&rft.au=Iserles,+A&rft.aulast=Iserles&rft.aufirst=A.&rft_val_fmt=info:ofi/fmt:kev:mtx:book&rfr_id=info:sid/primo.exlibrisgroup.com:primo-dedupmrg490532093",Book | A first course in the numerical analysis of differential equations | Iserles A 2009 |  | Publisher:Cambridge University Press ISBN:9780521734905,0,0,5,0,5,5,0,100,0,0,0,0,0
"getit.library.nyu.edu/resolve?umlaut.referent_id=18465443&url_ver=Z39.88-2004&url_ctx_fmt=info:ofi/fmt:kev:mtx:ctx&ctx_ver=Z39.88-2004&ctx_tim=2021-06-03T13:33:12-04:00&ctx_id=&ctx_enc=info:ofi/enc:UTF-8&rft.btitle=Law,+person,+and+community+philosophical,+theological,+and+comparative+perspectives+on+Canon+Law&rft.date=2012&rft.eisbn=0-19-993217-4&rft.eisbn_additional=0-19-987718-1&rft.eissn=9780199756773+0199756775&rft.genre=book&rft.isbn=0199932174&rft.isbn_additional=1-306-22496-9&rft.language=eng&rft.object_id=2550000001172439&rft.place=New+York&rft.primo=nyu_aleph003660190&rft.private_data=<nyu_aleph>003660190</nyu_aleph><grp_id>109371842</grp_id><oa></oa>&rft.pub=Oxford+University+Press&rft.title=Law,+person,+and+community+philosophical,+theological,+and+comparative+perspectives+on+Canon+Law&rft.au=Coughlin,+John+J.,+O.F.M&rft.aulast=Coughlin&rft.aufirst=John+J.,&rft_val_fmt=info:ofi/fmt:kev:mtx:book&rfr_id=info:sid/primo.exlibrisgroup.com:primo-nyu_aleph003660190",Book | Law person and community philosophical theological and comparative perspectives on canon law | Coughlin John J 2012 |  | Publisher:Oxford University Press ISBN:0199932174,0,0,3,0,3,3,0,100,0,0,0,0,0
"getit.library.nyu.edu/resolve?umlaut.referent_id=18467058&url_ver=Z39.88-2004&url_ctx_fmt=info:ofi/fmt:kev:mtx:ctx&ctx_ver=Z39.88-2004&ctx_tim=2021-06-07T17:48:52-04:00&ctx_id=&ctx_enc=info:ofi/enc:UTF-8&rft.au=Smith,+Ronald+D&rft.aucorp=Smith,+Ronald+D.&rft.aufirst=Ronald+D.&rft.auinitm=D&rft.aulast=Smith&rft.btitle=Becoming+a+Public+Relations+Writer+:+Strategic+Writing+for+Emerging+and+Established+Media.&rft.date=2016&rft.eisbn=1-317-30297-4&rft.eisbn_additional=978-1-317-30297-1&rft.eissn=9781138123052&rft.genre=book&rft.isbn=9781317302971&rft.language=eng&rft.object_id=3710000000820438&rft.oclcnum=956648721&rft.place=Florence&rft.primo=nyu_aleph004700602&rft.private_data=<nyu_aleph>004700602</nyu_aleph><grp_id>538089076</grp_id><oa></oa><url></url>&rft.pub=Taylor+and+Francis&rft.title=Becoming+a+Public+Relations+Writer+:+Strategic+Writing+for+Emerging+and+Established+Media.&rft.tpages=476&rft_val_fmt=info:ofi/fmt:kev:mtx:book&rfr_id=info:sid/primo.exlibrisgroup.com:primo-nyu_aleph004700602",Book | Becoming a Public Relations Writer Strategic Writing for Emerging and Established Media. | Smith Ronald D 2016 |  | Publisher:Taylor and Francis ISBN:9781317302971,0,0,1,0,1,1,0,100,0,0,0,0,0
"getit.library.nyu.edu/resolve?umlaut.referent_id=18473082&url_ver=Z39.88-2004&url_ctx_fmt=info:ofi/fmt:kev:mtx:ctx&ctx_ver=Z39.88-2004&ctx_tim=2021-06-10T07:11:26-04:00&ctx_id=&ctx_enc=info:ofi/enc:UTF-8&rft.btitle=Sketching+user+experiences+:+getting+the+design+right+and+the+right+design&rft.date=2010&rft.eisbn=1-281-03308-1&rft.eisbn_additional=9786611033088&rft.eissn=9780123740373+0123740371&rft.genre=book&rft.isbn=9780080552903&rft.language=eng&rft.lccn=2006036416&rft.object_id=1000000000383564&rft.oclcnum=180932034&rft.place=Amsterdam+;+Boston&rft.primo=dedupmrg372555860&rft.private_data=<nyu_aleph>003690618</nyu_aleph><grp_id>430264436</grp_id><oa></oa><url></url>&rft.pub=Elsevier/Morgan+Kaufmann&rft.stitle=SKETCHING+USER+EXPERIENCE&rft.title=Sketching+user+experiences+:+getting+the+design+right+and+the+right+design&rft.tpages=448&rft.au=Buxton,+William&rft.aulast=Buxton&rft.aufirst=William.&rft_val_fmt=info:ofi/fmt:kev:mtx:book&rfr_id=info:sid/primo.exlibrisgroup.com:primo-dedupmrg372555860",Book | Sketching user experiences getting the design right and the right design | Buxton William 2010 |  | Publisher:Elsevier/Morgan Kaufmann ISBN:9780080552903,0,0,7,0,7,7,0,100,0,0,0,0,0
getit.library.nyu.edu/resolve?umlaut.referent_id=18485831&url_ver=Z39.88-2004&url_ctx_fmt=info:ofi/fmt:kev:mtx:ctx&ctx_ver=Z39.88-2004&ctx_tim=2021-06-20T09:38:55-04:00&ctx_id=&ctx_enc=info:ofi/enc:UTF-8&rft_val_fmt=info:ofi/fmt:kev:mtx:database&rfr_id=info:sid/primo.exlibrisgroup.com:primo-nyu_aleph006248376,AnthroSource |  |  | undefined | undefined,0,0,1,0,1,1,0,100,0,0,0,0,0
"getit.library.nyu.edu/resolve?umlaut.referent_id=18495494&url_ver=Z39.88-2004&url_ctx_fmt=info:ofi/fmt:kev:mtx:ctx&ctx_ver=Z39.88-2004&ctx_tim=2021-06-29T09:28:41-04:00&ctx_id=&ctx_enc=info:ofi/enc:UTF-8&rft.au=Crawford,+Robert&rft.aucorp=Brennan&rft.aufirst=Robert,&rft.aulast=Crawford&rft.btitle=Global+advertising+practice+in+a+borderless+world&rft.date=2017&rft.eisbn=1-315-68862-X&rft.eisbn_additional=978-1-317-42169-6&rft.eissn=9781138918306&rft.genre=book&rft.isbn=9781315688626&rft.isbn_additional=978-1-317-42170-2&rft.language=eng&rft.lccn=2017015108&rft.object_id=3710000001409969&rft.oclcnum=980302683&rft.primo=nyu_aleph006085750&rft.private_data=<nyu_aleph>006085750</nyu_aleph><grp_id>555931971</grp_id><oa></oa><url></url>&rft.pub=Taylor+and+Francis&rft.title=Global+advertising+practice+in+a+borderless+world&rft.tpages=236&rft_val_fmt=info:ofi/fmt:kev:mtx:book&rfr_id=info:sid/primo.exlibrisgroup.com:primo-nyu_aleph006085750",Book | Global advertising practice in a borderless world | Crawford Robert 2017 |  | Publisher:Taylor and Francis ISBN:9781315688626,0,0,1,0,1,1,0,100,0,0,0,0,0
"getit.library.nyu.edu/resolve?umlaut.referent_id=18495943&url_ver=Z39.88-2004&url_ctx_fmt=info:ofi/fmt:kev:mtx:ctx&ctx_ver=Z39.88-2004&ctx_tim=2021-06-30T19:25:10-04:00&ctx_id=&ctx_enc=info:ofi/enc:UTF-8&rft.au=Harriet+Crawford&rft.aucorp=Crawford,+Harriet&rft.aufirst=Harriet+E.+W.&rft.aulast=Crawford&rft.btitle=The+Sumerian+world&rft.date=2013&rft.eisbn=1-136-21911-0&rft.eisbn_additional=978-0-203-09660-4&rft.eissn=9780415569675&rft.genre=book&rft.isbn=9781136219115&rft.isbn_additional=978-1-299-82888-9&rft.language=eng&rft.lccn=2012014796&rft.object_id=2550000001114284&rft.oclcnum=857769529&rft.place=Milton+Park,+Abingdon+;+New+York,+NY&rft.primo=dedupmrg481079907&rft.private_data=<nyu_aleph>004588863</nyu_aleph><grp_id>540128071</grp_id><oa></oa><url></url>&rft.pub=Routledge&rft.title=The+Sumerian+world&rft.tpages=688&rft_val_fmt=info:ofi/fmt:kev:mtx:book&rfr_id=info:sid/primo.exlibrisgroup.com:primo-dedupmrg481079907",Book | The Sumerian world | Harriet Crawford 2013 |  | Publisher:Routledge ISBN:9781136219115,0,0,1,0,1,1,0,100,0,0,0,0,0
getit.library.nyu.edu/resolve?umlaut.referent_id=18505306&url_ver=Z39.88-2004&url_ctx_fmt=info:ofi/fmt:kev:mtx:ctx&ctx_ver=Z39.88-2004&ctx_tim=2021-07-08T13:19:07-04:00&ctx_id=&ctx_enc=info:ofi/enc:UTF-8&rft_val_fmt=info:ofi/fmt:kev:mtx:video&rfr_id=info:sid/primo.exlibrisgroup.com:primo-nyu_aleph004882253,Children of Tibet the exile generation | Wearne Melinda |  |  | undefined,0,0,2,0,2,2,0,100,0,0,0,0,0
"getit.library.nyu.edu/resolve?umlaut.referent_id=18505958&url_ver=Z39.88-2004&url_ctx_fmt=info:ofi/fmt:kev:mtx:ctx&ctx_ver=Z39.88-2004&ctx_tim=2021-07-10T06:36:02-04:00&ctx_id=&ctx_enc=info:ofi/enc:UTF-8&rft.au=Griffiths,+D.+F.+(David+Francis)&rft.aucorp=Society+for+Industrial+and+Applied+Mathematics.&rft.aufirst=D.+F.&rft.auinitm=F&rft.aulast=Griffiths&rft.btitle=Learning+LATEX&rft.date=1997&rft.eisbn=0-89871-956-9&rft.genre=book&rft.isbn=9780898713831&rft.language=eng&rft.object_id=1000000000023419&rft.oclcnum=60830325&rft.place=Philadelphia&rft.primo=nyu_aleph005068945&rft.private_data=<nyu_aleph>005068945</nyu_aleph><grp_id>537928069</grp_id><oa></oa><url></url>&rft.pub=SIAM&rft.title=Learning+LATEX&rft.tpages=84&rft_val_fmt=info:ofi/fmt:kev:mtx:book&rfr_id=info:sid/primo.exlibrisgroup.com:primo-nyu_aleph005068945",Book | Learning LATEX | Griffiths D F David Francis 1997 |  | Publisher:SIAM ISBN:9780898713831,0,0,1,0,1,1,0,100,0,0,0,0,0
"getit.library.nyu.edu/resolve?umlaut.referent_id=18506437&url_ver=Z39.88-2004&url_ctx_fmt=info:ofi/fmt:kev:mtx:ctx&ctx_ver=Z39.88-2004&ctx_tim=2021-07-09T14:27:28-04:00&ctx_id=&ctx_enc=info:ofi/enc:UTF-8&rft.btitle=Morphologies+of+Asia+and+Africa&rft.date=2007&rft.eisbn=1-57506-566-5&rft.genre=book&rft.isbn=9781575065663&rft.language=eng&rft.lccn=2007015036&rft.object_id=2550000000040500&rft.oclcnum=773584648&rft.place=Winona+Lake,+Ind.&rft.primo=dedupmrg422440762&rft.private_data=<nyu_aleph>003571528</nyu_aleph><grp_id>478168553</grp_id><oa></oa><url></url>&rft.pub=Eisenbrauns&rft.title=Morphologies+of+Asia+and+Africa&rft.au=Kaye,+Alan+S.&rft.aulast=Kaye&rft.aufirst=Alan+S.&rft.auinitm=S&rft_val_fmt=info:ofi/fmt:kev:mtx:book&rfr_id=info:sid/primo.exlibrisgroup.com:primo-dedupmrg422440762",Book | Morphologies of Asia and Africa | Kaye Alan S 2007 |  | Publisher:Eisenbrauns ISBN:9781575065663,0,0,5,0,5,5,0,100,0,0,0,0,0
"getit.library.nyu.edu/resolve?umlaut.referent_id=18508753&url_ver=Z39.88-2004&url_ctx_fmt=info:ofi/fmt:kev:mtx:ctx&ctx_ver=Z39.88-2004&ctx_tim=2021-07-12T20:21:12-04:00&ctx_id=&ctx_enc=info:ofi/enc:UTF-8&rft.au=Griffiths,+D.+F.+(David+Francis)&rft.aucorp=Society+for+Industrial+and+Applied+Mathematics.&rft.aufirst=D.+F.&rft.auinitm=F&rft.aulast=Griffiths&rft.btitle=Learning+LATEX&rft.date=1997&rft.eisbn=0-89871-956-9&rft.genre=book&rft.isbn=9780898713831&rft.language=eng&rft.object_id=1000000000023419&rft.oclcnum=60830325&rft.place=Philadelphia&rft.primo=nyu_aleph005068945&rft.private_data=<nyu_aleph>005068945</nyu_aleph><grp_id>537928069</grp_id><oa></oa><url></url>&rft.pub=SIAM&rft.title=Learning+LATEX&rft.tpages=84&rft_val_fmt=info:ofi/fmt:kev:mtx:book&rfr_id=info:sid/primo.exlibrisgroup.com:primo-nyu_aleph005068945",Book | Learning LATEX | Griffiths D F David Francis 1997 |  | Publisher:SIAM ISBN:9780898713831,0,0,1,0,1,1,0,100,0,0,0,0,0
"getit.library.nyu.edu/resolve?umlaut.referent_id=18514237&url_ver=Z39.88-2004&url_ctx_fmt=info:ofi/fmt:kev:mtx:ctx&ctx_ver=Z39.88-2004&ctx_tim=2021-07-20T00:43:24-04:00&ctx_id=&ctx_enc=info:ofi/enc:UTF-8&rft.au=Norman,+Donald+A&rft.aufirst=Donald+A.&rft.auinitm=A&rft.aulast=Norman&rft.btitle=The+design+of+everyday+things&rft.date=2013&rft.eisbn=0-465-07299-2&rft.eisbn_additional=978-0-465-07299-6&rft.eissn=9780465050659&rft.genre=book&rft.isbn=9780465072996&rft.language=eng&rft.lccn=2013024417&rft.object_id=2670000000429825&rft.oclcnum=860902830&rft.place=New+York&rft.primo=dedupmrg430637150&rft.private_data=<nyu_aleph>003885337</nyu_aleph><grp_id>431254544</grp_id><oa></oa><url></url>&rft.pub=Basic+Books&rft.title=The+design+of+everyday+things&rft.tpages=384&rft_val_fmt=info:ofi/fmt:kev:mtx:book&rfr_id=info:sid/primo.exlibrisgroup.com:primo-dedupmrg430637150",Book | The design of everyday things | Norman Donald A 2013 |  | Publisher:Basic Books ISBN:9780465072996,0,0,3,0,3,3,0,100,0,0,0,0,0
"getit.library.nyu.edu/resolve?umlaut.referent_id=18515886&url_ver=Z39.88-2004&url_ctx_fmt=info:ofi/fmt:kev:mtx:ctx&ctx_ver=Z39.88-2004&ctx_tim=2021-07-19T18:14:10-04:00&ctx_id=&ctx_enc=info:ofi/enc:UTF-8&rft.atitle=Christian+Privilege:+Breaking+a+Sacred+Taboo&rft.au=Schlosser,+Lewis+Z&rft.aufirst=Lewis&rft.auinitm=Z&rft.aulast=Schlosser&rft.date=2003&rft.doi=10.1002/j.2161-1912.2003.tb00530.x&rft.eissn=2161-1912&rft.epage=51&rft.genre=article&rft.issn=0883-8534&rft.issue=1&rft.issue_start=1&rft.iuid=3141467&rft.jtitle=Journal+of+Multicultural+Counseling+and+Development&rft.language=eng&rft.lccn=+++85644529+&rft.month=01&rft.object_id=954925549331&rft.oclcnum=12199656&rft.place=Hoboken,+N.J.&rft.pub=Association+for+Multicultural+Counseling+and+Development&rft.spage=44&rft.stitle=JOURNAL+OF+MULTICULTURAL+COUNSELING+AND&rft.title=Journal+of+Multicultural+Counseling+and+Development&rft.volume=31&rft.volume_start=31&rft_val_fmt=info:ofi/fmt:kev:mtx:journal&rft_id=info:doi/10.1002/j.2161-1912.2003.tb00530.x&rfr_id=info:sid/wiley",Article | Christian Privilege Breaking a Sacred Taboo | Schlosser Lewis Z 2003 | Published in Journal Journal of Multicultural Counseling and Development Volume 31 Issue 1 Page 44 51. | ISSN:0883-8534,7,4,1,11,8,19,58,42,0,0,0,0,0
getit.library.nyu.edu/resolve?umlaut.referent_id=18518135&url_ver=Z39.88-2004&url_ctx_fmt=info:ofi/fmt:kev:mtx:ctx&ctx_ver=Z39.88-2004&ctx_tim=2021-07-22T07:35:19-04:00&ctx_id=&ctx_enc=info:ofi/enc:UTF-8&rft.jtitle=Journal+for+Islamic+Studies&rft_val_fmt=info:ofi/fmt:kev:mtx:journal&rfr_id=info:sid/umlaut.code4lib.org:opensearch,Journal | Journal for Islamic studies |  | ISSN:0257-7062 | undefined,3,0,1,3,4,7,43,57,0,0,0,0,0
"getit.library.nyu.edu/resolve?umlaut.referent_id=18527609&url_ver=Z39.88-2004&url_ctx_fmt=info:ofi/fmt:kev:mtx:ctx&ctx_ver=Z39.88-2004&ctx_tim=2021-08-02T00:03:26-04:00&ctx_id=&ctx_enc=info:ofi/enc:UTF-8&rft.btitle=Learning+LATEX&rft.date=1997&rft.eisbn=0-89871-956-9&rft.genre=book&rft.isbn=9780898713831&rft.language=eng&rft.object_id=1000000000023419&rft.oclcnum=60830325&rft.place=Philadelphia&rft.primo=nyu_aleph005068945&rft.private_data=<nyu_aleph>005068945</nyu_aleph><grp_id>537928069</grp_id><oa></oa><url></url>&rft.pub=SIAM&rft.title=Learning+LATEX&rft.tpages=84&rft.au=Griffiths,+D.+F.+(David+Francis)&rft.aucorp=Society+for+Industrial+and+Applied+Mathematics.&rft.aulast=Griffiths&rft.aufirst=D.+F.&rft.auinitm=F&rft_val_fmt=info:ofi/fmt:kev:mtx:book&rfr_id=info:sid/primo.exlibrisgroup.com:primo-nyu_aleph005068945",Book | Learning LATEX | Griffiths D F David Francis 1997 |  | Publisher:SIAM ISBN:9780898713831,0,0,1,0,1,1,0,100,0,0,0,0,0
"getit.library.nyu.edu/resolve?umlaut.referent_id=18528035&url_ver=Z39.88-2004&url_ctx_fmt=info:ofi/fmt:kev:mtx:ctx&ctx_ver=Z39.88-2004&ctx_tim=2021-08-02T11:39:13-04:00&ctx_id=&ctx_enc=info:ofi/enc:UTF-8&rft.btitle=International+encyclopedia+of+education&rft.date=2010&rft.eisbn=1-78034-329-9&rft.eisbn_additional=9786612732478&rft.eissn=9780080448930&rft.genre=book&rft.isbn=9780080448947&rft.isbn_additional=978-0-08-044893-0&rft.language=eng&rft.object_id=2550000000014142&rft.oclcnum=645208716&rft.place=Oxford&rft.primo=nyu_aleph004473414&rft.private_data=<nyu_aleph>004473414</nyu_aleph><grp_id>543186393</grp_id><oa></oa><url></url>&rft.pub=Elsevier&rft.stitle=INTERNATIONAL+ENCYCLOPEDIA+OF+EDUCATION&rft.title=International+encyclopedia+of+education&rft.tpages=8400&rft.au=Peterson,+Penelope;+Baker,+Eva;+McGaw,+Barry&rft.aulast=Peterson&rft.aufirst=Penelope+L.,&rft.auinitm=B&rft_val_fmt=info:ofi/fmt:kev:mtx:book&rfr_id=info:sid/primo.exlibrisgroup.com:primo-nyu_aleph004473414",Book | International encyclopedia of education | Peterson Penelope 2010 |  | Publisher:Elsevier ISBN:9780080448947,0,0,1,0,1,1,0,100,0,0,0,0,0
"getit.library.nyu.edu/resolve?umlaut.referent_id=18532741&url_ver=Z39.88-2004&url_ctx_fmt=info:ofi/fmt:kev:mtx:ctx&ctx_ver=Z39.88-2004&ctx_tim=2021-08-08T01:13:33-04:00&ctx_id=&ctx_enc=info:ofi/enc:UTF-8&rft.btitle=Revista+colombiana+de+sociolog\u00eda.&rft.eissn=2256-5485&rft.genre=journal&rft.issn=0120159X&rft.jtitle=Revista+Colombiana+de+Sociolog\u00eda&rft.language=spa&rft.lccn=+++84642862+&rft.object_id=991042728719606&rft.oclcnum=651914665&rft.place=Bogota\u0301,+Colombia&rft.private_data=<NSMARCIT>991042728719606</NSMARCIT>&rft.pub=El+Departamento&rft.title=Revista+colombiana+de+sociolog\u00eda.&rft_val_fmt=info:ofi/fmt:kev:mtx:journal&rfr_id=info:sid/primo.exlibrisgroup.com:primo-dedupmrg294559804",Journal | Revista colombiana de sociolog\u00eda. |  | ISSN:0120-159X | undefined,2,1,1,3,3,6,50,50,0,0,0,0,0
"getit.library.nyu.edu/resolve?umlaut.referent_id=18550648&url_ver=Z39.88-2004&url_ctx_fmt=info:ofi/fmt:kev:mtx:ctx&ctx_ver=Z39.88-2004&ctx_tim=2021-08-29T20:56:36-04:00&ctx_id=&ctx_enc=info:ofi/enc:UTF-8&rft.btitle=The+new+Cambridge+history+of+American+foreign+relations.+Volume+3,+The+globalizing+of+America,+1913-1945&rft.date=2013&rft.eisbn=0-511-98058-2&rft.eissn=9780521763288&rft.genre=book&rft.isbn=9780511980589&rft.isbn_additional=978-1-107-53619-7&rft.language=eng&rft.object_id=2670000000361521&rft.oclcnum=852970447&rft.place=Cambridge&rft.primo=nyu_aleph004860016&rft.private_data=<nyu_aleph>004860016</nyu_aleph><grp_id>538311651</grp_id><oa></oa><url></url>&rft.pub=Cambridge+University+Press&rft.title=The+new+Cambridge+history+of+American+foreign+relations.+Volume+3,+The+globalizing+of+America,+1913-1945&rft.au=Iriye,+Akira,+author&rft.aulast=Iriye&rft.aufirst=Akira,&rft_val_fmt=info:ofi/fmt:kev:mtx:book&rfr_id=info:sid/primo.exlibrisgroup.com:primo-nyu_aleph004860016",Book | The new Cambridge history of American foreign relations Volume 3 The globalizing of America 1913-1945 | Iriye Akira 2013 |  | Publisher:Cambridge University Press ISBN:9780511980589,0,0,1,0,1,1,0,100,0,0,0,0,0
"getit.library.nyu.edu/resolve?umlaut.referent_id=18556626&url_ver=Z39.88-2004&url_ctx_fmt=info:ofi/fmt:kev:mtx:ctx&ctx_ver=Z39.88-2004&ctx_tim=2021-09-05T17:30:36-04:00&ctx_id=&ctx_enc=info:ofi/enc:UTF-8&rft.au=Norman,+Donald+A&rft.aufirst=Donald+A.&rft.auinitm=A&rft.aulast=Norman&rft.btitle=The+design+of+everyday+things&rft.date=2013&rft.eisbn=0-465-07299-2&rft.eisbn_additional=978-0-465-07299-6&rft.eissn=9780465050659&rft.genre=book&rft.isbn=9780465072996&rft.language=eng&rft.lccn=2013024417&rft.object_id=2670000000429825&rft.oclcnum=869567342&rft.place=New+York&rft.primo=dedupmrg430637150&rft.private_data=<nyu_aleph>003885337</nyu_aleph><grp_id>431254544</grp_id><oa></oa><url></url>&rft.pub=Basic+Books&rft.title=The+design+of+everyday+things&rft.tpages=384&rft_val_fmt=info:ofi/fmt:kev:mtx:book&rfr_id=info:sid/primo.exlibrisgroup.com:primo-dedupmrg430637150",Book | The design of everyday things | Norman Donald A 2013 |  | Publisher:Basic Books ISBN:9780465072996,0,0,3,0,3,3,0,100,0,0,0,0,0
"getit.library.nyu.edu/resolve?umlaut.referent_id=18558333&url_ver=Z39.88-2004&url_ctx_fmt=info:ofi/fmt:kev:mtx:ctx&ctx_ver=Z39.88-2004&ctx_tim=2021-09-09T11:45:53-04:00&ctx_id=&ctx_enc=info:ofi/enc:UTF-8&rft.au=Butsch,+Richard&rft.aufirst=Richard,&rft.aulast=Butsch&rft.btitle=The+making+of+American+audiences+from+stage+to+television,+1750-1990&rft.date=2000&rft.eisbn=0-511-39518-3&rft.eisbn_additional=9786613437259&rft.eissn=0521662532+9780521662536+0521664837+9780521664837&rft.genre=book&rft.isbn=0511619715&rft.isbn_additional=978-0-521-66483-7&rft.language=eng&rft.lccn=99036490&rft.object_id=2560000000071407&rft.oclcnum=711906301&rft.place=Cambridge+;+New+York&rft.primo=dedupmrg492075512&rft.private_data=<nyu_aleph>005829119</nyu_aleph><grp_id>552898914</grp_id><oa></oa><url></url>&rft.pub=Cambridge+University+Press&rft.stitle=MAKING+OF+AMERICAN+AUDIENCES+:+FROM+STAGE+TO+TELEVISION,+1750-1990&rft.title=The+making+of+American+audiences+from+stage+to+television,+1750-1990&rft_val_fmt=info:ofi/fmt:kev:mtx:book&rfr_id=info:sid/primo.exlibrisgroup.com:primo-dedupmrg492075512",Book | The making of American audiences from stage to television 1750-1990 | Butsch Richard 2000 |  | Publisher:Cambridge University Press ISBN:0511619715,1,0,6,1,7,8,13,88,0,0,0,0,0
"getit.library.nyu.edu/resolve?umlaut.referent_id=18558960&url_ver=Z39.88-2004&url_ctx_fmt=info:ofi/fmt:kev:mtx:ctx&ctx_ver=Z39.88-2004&ctx_tim=2021-09-07T01:34:03-04:00&ctx_id=&ctx_enc=info:ofi/enc:UTF-8&rft.au=Lupton,+Ellen&rft.aucorp=Phillips,+Jennifer+Cole&rft.aufirst=Ellen,&rft.aulast=Lupton&rft.btitle=Graphic+design+:+the+new+basics&rft.date=2015&rft.eisbn=1-61689-455-5&rft.eissn=9781568987705&rft.genre=book&rft.isbn=9781616894559&rft.isbn_additional=978-1-61689-325-5&rft.language=eng&rft.lccn=2014046286&rft.object_id=3710000000721136&rft.oclcnum=914231573&rft.place=New+York,+NY&rft.primo=dedupmrg418740973&rft.private_data=<nyu_aleph>004383181</nyu_aleph><grp_id>433310185</grp_id><oa></oa><url></url>&rft.pub=Princeton+Architectural+Press&rft.title=Graphic+design+:+the+new+basics&rft.tpages=264&rft_val_fmt=info:ofi/fmt:kev:mtx:book&rfr_id=info:sid/primo.exlibrisgroup.com:primo-dedupmrg418740973",Book | Graphic design the new basics | Lupton Ellen 2015 |  | Publisher:Princeton Architectural Press ISBN:9781616894559,0,0,2,0,2,2,0,100,0,0,0,0,0
"getit.library.nyu.edu/resolve?umlaut.referent_id=18558960&url_ver=Z39.88-2004&url_ctx_fmt=info:ofi/fmt:kev:mtx:ctx&ctx_ver=Z39.88-2004&ctx_tim=2021-09-08T17:29:29-04:00&ctx_id=&ctx_enc=info:ofi/enc:UTF-8&rft.au=Lupton,+Ellen&rft.aucorp=Phillips,+Jennifer+Cole&rft.aufirst=Ellen,&rft.aulast=Lupton&rft.btitle=Graphic+design+:+the+new+basics&rft.date=2015&rft.eisbn=1-61689-455-5&rft.eissn=9781568987705&rft.genre=book&rft.isbn=9781616894559&rft.isbn_additional=978-1-61689-325-5&rft.language=eng&rft.lccn=2014046286&rft.object_id=3710000000721136&rft.oclcnum=914231573&rft.place=New+York,+NY&rft.primo=dedupmrg418740973&rft.private_data=<nyu_aleph>004383181</nyu_aleph><grp_id>433310185</grp_id><oa></oa><url></url>&rft.pub=Princeton+Architectural+Press&rft.title=Graphic+design+:+the+new+basics&rft.tpages=264&rft_val_fmt=info:ofi/fmt:kev:mtx:book&rfr_id=info:sid/primo.exlibrisgroup.com:primo-dedupmrg418740973",Book | Graphic design the new basics | Lupton Ellen 2015 |  | Publisher:Princeton Architectural Press ISBN:9781616894559,0,0,2,0,2,2,0,100,0,0,0,0,0
"getit.library.nyu.edu/resolve?umlaut.referent_id=18558960&url_ver=Z39.88-2004&url_ctx_fmt=info:ofi/fmt:kev:mtx:ctx&ctx_ver=Z39.88-2004&ctx_tim=2021-09-08T17:38:56-04:00&ctx_id=&ctx_enc=info:ofi/enc:UTF-8&rft.au=Lupton,+Ellen&rft.aucorp=Phillips,+Jennifer+Cole&rft.aufirst=Ellen,&rft.aulast=Lupton&rft.btitle=Graphic+design+:+the+new+basics&rft.date=2015&rft.eisbn=1-61689-455-5&rft.eissn=9781568987705&rft.genre=book&rft.isbn=9781616894559&rft.isbn_additional=978-1-61689-325-5&rft.language=eng&rft.lccn=2014046286&rft.object_id=3710000000721136&rft.oclcnum=914231573&rft.place=New+York,+NY&rft.primo=dedupmrg418740973&rft.private_data=<nyu_aleph>004383181</nyu_aleph><grp_id>433310185</grp_id><oa></oa><url></url>&rft.pub=Princeton+Architectural+Press&rft.title=Graphic+design+:+the+new+basics&rft.tpages=264&rft_val_fmt=info:ofi/fmt:kev:mtx:book&rfr_id=info:sid/primo.exlibrisgroup.com:primo-dedupmrg418740973",Book | Graphic design the new basics | Lupton Ellen 2015 |  | Publisher:Princeton Architectural Press ISBN:9781616894559,0,0,2,0,2,2,0,100,0,0,0,0,0
"getit.library.nyu.edu/resolve?umlaut.referent_id=18558960&url_ver=Z39.88-2004&url_ctx_fmt=info:ofi/fmt:kev:mtx:ctx&ctx_ver=Z39.88-2004&ctx_tim=2021-09-16T21:33:12-04:00&ctx_id=&ctx_enc=info:ofi/enc:UTF-8&rft.au=Lupton,+Ellen&rft.aucorp=Phillips,+Jennifer+Cole&rft.aufirst=Ellen,&rft.aulast=Lupton&rft.btitle=Graphic+design+:+the+new+basics&rft.date=2015&rft.eisbn=1-61689-455-5&rft.eissn=9781568987705&rft.genre=book&rft.isbn=9781616894559&rft.isbn_additional=978-1-61689-325-5&rft.language=eng&rft.lccn=2014046286&rft.object_id=3710000000721136&rft.oclcnum=914231573&rft.place=New+York,+NY&rft.primo=dedupmrg418740973&rft.private_data=<nyu_aleph>004383181</nyu_aleph><grp_id>433310185</grp_id><oa></oa><url></url>&rft.pub=Princeton+Architectural+Press&rft.title=Graphic+design+:+the+new+basics&rft.tpages=264&rft_val_fmt=info:ofi/fmt:kev:mtx:book&rfr_id=info:sid/primo.exlibrisgroup.com:primo-dedupmrg418740973",Book | Graphic design the new basics | Lupton Ellen 2015 |  | Publisher:Princeton Architectural Press ISBN:9781616894559,0,0,2,0,2,2,0,100,0,0,0,0,0
"getit.library.nyu.edu/resolve?umlaut.referent_id=18559438&url_ver=Z39.88-2004&url_ctx_fmt=info:ofi/fmt:kev:mtx:ctx&ctx_ver=Z39.88-2004&ctx_tim=2021-09-07T12:07:36-04:00&ctx_id=&ctx_enc=info:ofi/enc:UTF-8&rft.btitle=Formal+Semantics+:+the+Essential+Readings.&rft.date=2008&rft.eisbn=0-470-75833-3&rft.eisbn_additional=9786611321284&rft.eissn=9780631215417&rft.genre=book&rft.isbn=9780470758182&rft.language=eng&rft.object_id=1000000000415378&rft.oclcnum=476170785&rft.place=Chichester&rft.primo=nyu_aleph004755770&rft.private_data=<nyu_aleph>004755770</nyu_aleph><grp_id>480071243</grp_id><oa></oa><url></url>&rft.pub=John+Wiley+&+Sons=&rft.stitle=FORMAL+SEMANTICS&rft.title=Formal+Semantics+:+the+Essential+Readings.&rft.tpages=496&rft.au=Portner,+Paul+H&rft.aulast=Portner&rft.aufirst=Paul+H.&rft.auinitm=H&rft_val_fmt=info:ofi/fmt:kev:mtx:book&rfr_id=info:sid/primo.exlibrisgroup.com:primo-nyu_aleph004755770",Book | Formal semantics the essential readings | Portner Paul H 2008 |  | Publisher:Blackwell Publishers Ltd ISBN:9780470758182,0,0,1,0,1,1,0,100,0,0,0,0,0
"getit.library.nyu.edu/resolve?umlaut.referent_id=18561723&url_ver=Z39.88-2004&url_ctx_fmt=info:ofi/fmt:kev:mtx:ctx&ctx_ver=Z39.88-2004&ctx_tim=2021-09-14T10:23:19-04:00&ctx_id=&ctx_enc=info:ofi/enc:UTF-8&rft.au=Jones,+Andrew+F.&rft.aufirst=Andrew+F.,&rft.auinitm=F&rft.aulast=Jones&rft.btitle=Yellow+music+:+media+culture+and+colonial+modernity+in+the+Chinese+jazz+age&rft.date=2001&rft.eisbn=1-283-06200-3&rft.eisbn_additional=9786613062000&rft.eissn=082232685X&rft.genre=book&rft.isbn=0822380439&rft.isbn_additional=978-0-8223-2694-6&rft.language=eng&rft.lccn=2001017335&rft.object_id=111056486755918&rft.oclcnum=52342315&rft.place=Durham&rft.primo=dedupmrg372218522&rft.private_data=<nyu_aleph>004801524</nyu_aleph><grp_id>433626842</grp_id><oa></oa><url></url>&rft.pub=Duke+University+Press&rft.title=Yellow+music+:+media+culture+and+colonial+modernity+in+the+Chinese+jazz+age&rft.tpages=224&rft_val_fmt=info:ofi/fmt:kev:mtx:book&rfr_id=info:sid/primo.exlibrisgroup.com:primo-dedupmrg372218522",Book | Yellow music media culture and colonial modernity in the Chinese jazz age | Jones Andrew F 2001 |  | Publisher:Duke University Press ISBN:0822380439,0,0,4,0,4,4,0,100,0,0,0,0,0
"getit.library.nyu.edu/resolve?umlaut.referent_id=18561723&url_ver=Z39.88-2004&url_ctx_fmt=info:ofi/fmt:kev:mtx:ctx&ctx_ver=Z39.88-2004&ctx_tim=2021-09-15T22:31:37-04:00&ctx_id=&ctx_enc=info:ofi/enc:UTF-8&rft.au=Jones,+Andrew+F.&rft.aufirst=Andrew+F.,&rft.auinitm=F&rft.aulast=Jones&rft.btitle=Yellow+music+:+media+culture+and+colonial+modernity+in+the+Chinese+jazz+age&rft.date=2001&rft.eisbn=1-283-06200-3&rft.eisbn_additional=9786613062000&rft.eissn=082232685X&rft.genre=book&rft.isbn=0822380439&rft.isbn_additional=978-0-8223-2694-6&rft.language=eng&rft.lccn=2001017335&rft.object_id=111056486755918&rft.oclcnum=52342315&rft.place=Durham&rft.primo=dedupmrg372218522&rft.private_data=<nyu_aleph>004801524</nyu_aleph><grp_id>433626842</grp_id><oa></oa><url></url>&rft.pub=Duke+University+Press&rft.title=Yellow+music+:+media+culture+and+colonial+modernity+in+the+Chinese+jazz+age&rft.tpages=224&rft_val_fmt=info:ofi/fmt:kev:mtx:book&rfr_id=info:sid/primo.exlibrisgroup.com:primo-dedupmrg372218522",Book | Yellow music media culture and colonial modernity in the Chinese jazz age | Jones Andrew F 2001 |  | Publisher:Duke University Press ISBN:0822380439,0,0,4,0,4,4,0,100,0,0,0,0,0
"getit.library.nyu.edu/resolve?umlaut.referent_id=18565554&url_ver=Z39.88-2004&url_ctx_fmt=info:ofi/fmt:kev:mtx:ctx&ctx_ver=Z39.88-2004&ctx_tim=2021-09-13T13:14:54-04:00&ctx_id=&ctx_enc=info:ofi/enc:UTF-8&rft.au=Currid,+Brian&rft.aufirst=Brian.&rft.aulast=Currid&rft.btitle=A+national+acoustics+:+music+and+mass+publicity+in+Weimar+and+Nazi+Germany&rft.date=2006&rft.eisbn=0-8166-9419-2&rft.eissn=0816640416+9780816640416&rft.genre=book&rft.isbn=9780816694198&rft.isbn_additional=978-0-8166-4042-3&rft.language=eng&rft.lccn=2006001059&rft.object_id=1000000000346802&rft.oclcnum=166289748&rft.place=Minneapolis&rft.primo=dedupmrg372432882&rft.private_data=<nyu_aleph>003166495</nyu_aleph><grp_id>433630251</grp_id><oa></oa><url></url>&rft.pub=University+of+Minnesota+Press&rft.stitle=NATIONAL+ACOUSTICS&rft.title=A+national+acoustics+:+music+and+mass+publicity+in+Weimar+and+Nazi+Germany&rft.tpages=279&rft_val_fmt=info:ofi/fmt:kev:mtx:book&rfr_id=info:sid/primo.exlibrisgroup.com:primo-dedupmrg372432882",Book | A national acoustics music and mass publicity in Weimar and Nazi Germany | Currid Brian 2006 |  | Publisher:University of Minnesota Press ISBN:9780816694198,0,0,6,0,6,6,0,100,0,0,0,0,0
"getit.library.nyu.edu/resolve?umlaut.referent_id=18568035&url_ver=Z39.88-2004&url_ctx_fmt=info:ofi/fmt:kev:mtx:ctx&ctx_ver=Z39.88-2004&ctx_tim=2021-09-16T09:53:54-04:00&ctx_id=&ctx_enc=info:ofi/enc:UTF-8&rft.au=Norman,+Donald+A&rft.aufirst=Donald+A.&rft.auinitm=A&rft.aulast=Norman&rft.btitle=The+design+of+everyday+things&rft.date=2013&rft.eisbn=0-465-07299-2&rft.eisbn_additional=978-0-465-07299-6&rft.eissn=9780465050659&rft.genre=book&rft.isbn=9780465072996&rft.language=eng&rft.lccn=2013024417&rft.object_id=2670000000429825&rft.oclcnum=860902830&rft.place=New+York&rft.primo=dedupmrg430637150&rft.private_data=<nyu_aleph>003885337</nyu_aleph><grp_id>431254544</grp_id><oa></oa><url></url>&rft.pub=Basic+Books&rft.title=The+design+of+everyday+things&rft.tpages=384&rft_val_fmt=info:ofi/fmt:kev:mtx:book&rfr_id=info:sid/primo.exlibrisgroup.com:primo-dedupmrg430637150",Book | The design of everyday things | Norman Donald A 2013 |  | Publisher:Basic Books ISBN:9780465072996,0,0,3,0,3,3,0,100,0,0,0,0,0
"getit.library.nyu.edu/resolve?umlaut.referent_id=18568035&url_ver=Z39.88-2004&url_ctx_fmt=info:ofi/fmt:kev:mtx:ctx&ctx_ver=Z39.88-2004&ctx_tim=2021-09-16T14:09:30-04:00&ctx_id=&ctx_enc=info:ofi/enc:UTF-8&rft.au=Norman,+Donald+A&rft.aufirst=Donald+A.&rft.auinitm=A&rft.aulast=Norman&rft.btitle=The+design+of+everyday+things&rft.date=2013&rft.eisbn=0-465-07299-2&rft.eisbn_additional=978-0-465-07299-6&rft.eissn=9780465050659&rft.genre=book&rft.isbn=9780465072996&rft.language=eng&rft.lccn=2013024417&rft.object_id=2670000000429825&rft.oclcnum=860902830&rft.place=New+York&rft.primo=dedupmrg430637150&rft.private_data=<nyu_aleph>003885337</nyu_aleph><grp_id>431254544</grp_id><oa></oa><url></url>&rft.pub=Basic+Books&rft.title=The+design+of+everyday+things&rft.tpages=384&rft_val_fmt=info:ofi/fmt:kev:mtx:book&rfr_id=info:sid/primo.exlibrisgroup.com:primo-dedupmrg430637150",Book | The design of everyday things | Norman Donald A 2013 |  | Publisher:Basic Books ISBN:9780465072996,0,0,3,0,3,3,0,100,0,0,0,0,0
"getit.library.nyu.edu/resolve?umlaut.referent_id=18568201&url_ver=Z39.88-2004&url_ctx_fmt=info:ofi/fmt:kev:mtx:ctx&ctx_ver=Z39.88-2004&ctx_tim=2021-09-14T18:53:24-04:00&ctx_id=&ctx_enc=info:ofi/enc:UTF-8&rft.au=Smith,+Ronald+D&rft.aucorp=Smith,+Ronald+D.&rft.aufirst=Ronald+D.&rft.auinitm=D&rft.aulast=Smith&rft.btitle=Becoming+a+Public+Relations+Writer+:+Strategic+Writing+for+Emerging+and+Established+Media.&rft.date=2016&rft.eisbn=1-317-30297-4&rft.eisbn_additional=978-1-317-30297-1&rft.eissn=9781138123052&rft.genre=book&rft.isbn=9781317302971&rft.language=eng&rft.object_id=3710000000820438&rft.oclcnum=956648721&rft.place=Florence&rft.primo=nyu_aleph004700602&rft.private_data=<nyu_aleph>004700602</nyu_aleph><grp_id>538089076</grp_id><oa></oa><url></url>&rft.pub=Taylor+and+Francis&rft.title=Becoming+a+Public+Relations+Writer+:+Strategic+Writing+for+Emerging+and+Established+Media.&rft.tpages=476&rft_val_fmt=info:ofi/fmt:kev:mtx:book&rfr_id=info:sid/primo.exlibrisgroup.com:primo-nyu_aleph004700602",Book | Becoming a Public Relations Writer Strategic Writing for Emerging and Established Media. | Smith Ronald D 2016 |  | Publisher:Taylor and Francis ISBN:9781317302971,0,0,1,0,1,1,0,100,0,0,0,0,0
"getit.library.nyu.edu/resolve?umlaut.referent_id=18568201&url_ver=Z39.88-2004&url_ctx_fmt=info:ofi/fmt:kev:mtx:ctx&ctx_ver=Z39.88-2004&ctx_tim=2021-09-15T10:48:51-04:00&ctx_id=&ctx_enc=info:ofi/enc:UTF-8&rft.au=Smith,+Ronald+D&rft.aucorp=Smith,+Ronald+D.&rft.aufirst=Ronald+D.&rft.auinitm=D&rft.aulast=Smith&rft.btitle=Becoming+a+Public+Relations+Writer+:+Strategic+Writing+for+Emerging+and+Established+Media.&rft.date=2016&rft.eisbn=1-317-30297-4&rft.eisbn_additional=978-1-317-30297-1&rft.eissn=9781138123052&rft.genre=book&rft.isbn=9781317302971&rft.language=eng&rft.object_id=3710000000820438&rft.oclcnum=956648721&rft.place=Florence&rft.primo=nyu_aleph004700602&rft.private_data=<nyu_aleph>004700602</nyu_aleph><grp_id>538089076</grp_id><oa></oa><url></url>&rft.pub=Taylor+and+Francis&rft.title=Becoming+a+Public+Relations+Writer+:+Strategic+Writing+for+Emerging+and+Established+Media.&rft.tpages=476&rft_val_fmt=info:ofi/fmt:kev:mtx:book&rfr_id=info:sid/primo.exlibrisgroup.com:primo-nyu_aleph004700602",Book | Becoming a Public Relations Writer Strategic Writing for Emerging and Established Media. | Smith Ronald D 2016 |  | Publisher:Taylor and Francis ISBN:9781317302971,0,0,1,0,1,1,0,100,0,0,0,0,0
"getit.library.nyu.edu/resolve?umlaut.referent_id=18575366&url_ver=Z39.88-2004&url_ctx_fmt=info:ofi/fmt:kev:mtx:ctx&ctx_ver=Z39.88-2004&ctx_tim=2021-09-18T18:08:42-04:00&ctx_id=&ctx_enc=info:ofi/enc:UTF-8&rft.btitle=A+national+acoustics+:+music+and+mass+publicity+in+Weimar+and+Nazi+Germany&rft.date=2006&rft.eisbn=0-8166-9419-2&rft.eissn=0816640416+9780816640416&rft.genre=book&rft.isbn=9780816694198&rft.isbn_additional=978-0-8166-4042-3&rft.language=eng&rft.lccn=2006001059&rft.object_id=1000000000346802&rft.oclcnum=166289748&rft.place=Minneapolis&rft.primo=dedupmrg372432882&rft.private_data=<nyu_aleph>003166495</nyu_aleph><grp_id>433630251</grp_id><oa></oa><url></url>&rft.pub=University+of+Minnesota+Press&rft.stitle=NATIONAL+ACOUSTICS&rft.title=A+national+acoustics+:+music+and+mass+publicity+in+Weimar+and+Nazi+Germany&rft.tpages=279&rft.au=Currid,+Brian&rft.aulast=Currid&rft.aufirst=Brian.&rft_val_fmt=info:ofi/fmt:kev:mtx:book&rfr_id=info:sid/primo.exlibrisgroup.com:primo-dedupmrg372432882",Book | A national acoustics music and mass publicity in Weimar and Nazi Germany | Currid Brian 2006 |  | Publisher:University of Minnesota Press ISBN:9780816694198,0,0,6,0,6,6,0,100,0,0,0,0,0
"getit.library.nyu.edu/resolve?umlaut.referent_id=18582157&url_ver=Z39.88-2004&url_ctx_fmt=info:ofi/fmt:kev:mtx:ctx&ctx_ver=Z39.88-2004&ctx_tim=2021-09-22T16:30:32-04:00&ctx_id=&ctx_enc=info:ofi/enc:UTF-8&rft.btitle=Becoming+a+Public+Relations+Writer+:+Strategic+Writing+for+Emerging+and+Established+Media.&rft.date=2016&rft.eisbn=1-317-30297-4&rft.eissn=9781138123052&rft.genre=book&rft.isbn=9781317302971&rft.language=eng&rft.object_id=3710000000820438&rft.oclcnum=956648721&rft.place=Florence&rft.primo=nyu_aleph004700602&rft.private_data=<nyu_aleph>004700602</nyu_aleph><grp_id>538089076</grp_id><oa></oa><url></url>&rft.pub=Taylor+and+Francis&rft.title=Becoming+a+Public+Relations+Writer+:+Strategic+Writing+for+Emerging+and+Established+Media.&rft.tpages=476&rft.au=Smith,+Ronald+D&rft.aucorp=Smith,+Ronald+D.&rft.aulast=Smith&rft.aufirst=Ronald+D.&rft.auinitm=D&rft_val_fmt=info:ofi/fmt:kev:mtx:book&rfr_id=info:sid/primo.exlibrisgroup.com:primo-nyu_aleph004700602",Book | Becoming a Public Relations Writer Strategic Writing for Emerging and Established Media. | Smith Ronald D 2016 |  | Publisher:Taylor and Francis ISBN:9781317302971,0,0,1,0,1,1,0,100,0,0,0,0,0
getit.library.nyu.edu/resolve?umlaut.referent_id=18582429&url_ver=Z39.88-2004&url_ctx_fmt=info:ofi/fmt:kev:mtx:ctx&ctx_ver=Z39.88-2004&ctx_tim=2021-09-22T18:59:13-04:00&ctx_id=&ctx_enc=info:ofi/enc:UTF-8&rft.jtitle=Journal+for+Islamic+Studies&rft_val_fmt=info:ofi/fmt:kev:mtx:journal&rfr_id=info:sid/umlaut.code4lib.org:opensearch,Journal | Journal for Islamic studies |  | ISSN:0257-7062 | undefined,1,0,3,1,4,5,20,80,0,0,0,0,0
"getit.library.nyu.edu/resolve?umlaut.referent_id=18587922&url_ver=Z39.88-2004&url_ctx_fmt=info:ofi/fmt:kev:mtx:ctx&ctx_ver=Z39.88-2004&ctx_tim=2021-09-26T15:21:43-04:00&ctx_id=&ctx_enc=info:ofi/enc:UTF-8&rft.btitle=Digital+typography+using+LaTeX&rft.date=2003&rft.eisbn=1-280-00935-7&rft.eisbn_additional=9786610009350&rft.genre=book&rft.isbn=0387952179&rft.language=eng&rft.lccn=2002070557&rft.object_id=111087027060340&rft.oclcnum=49959273&rft.place=New+York&rft.primo=dedupmrg128965021&rft.private_data=<nyu_aleph>003169332</nyu_aleph><grp_id>130719124</grp_id><oa></oa>&rft.pub=Springer&rft.stitle=DIGITAL+TYPOGRAPHY+USING+LATEX&rft.title=Digital+typography+using+LaTeX&rft.tpages=510&rft.au=Syropoulos,+Apostolos&rft.aulast=Syropoulos&rft.aufirst=Apostolos.&rft_val_fmt=info:ofi/fmt:kev:mtx:book&rfr_id=info:sid/primo.exlibrisgroup.com:primo-dedupmrg128965021",Book | Digital typography using LaTeX | Syropoulos Apostolos 2003 |  | Publisher:Springer ISBN:0387952179,0,0,2,0,2,2,0,100,0,0,0,0,0
"getit.library.nyu.edu/resolve?umlaut.referent_id=18593193&url_ver=Z39.88-2004&url_ctx_fmt=info:ofi/fmt:kev:mtx:ctx&ctx_ver=Z39.88-2004&ctx_tim=2021-09-28T21:05:53-04:00&ctx_id=&ctx_enc=info:ofi/enc:UTF-8&rft.private_data=<nyu_aleph>000246777</nyu_aleph><grp_id>52427906</grp_id><oa></oa>&rft.genre=journal&rft.issn=00377651&rft.jtitle=Social+and+Economic+Studies&rft.language=eng&rft.lccn=++2011234206&rft.object_id=960239073771&rft.object_type=JOURNAL&rft.place=Mona,+Jamaica&rft.primo=dedupmrg49102228&rft.pub=Institute+of+Social+and+Economic+Research&rft.stitle=SOC+ECON+STUD&rft.title=Social+and+Economic+Studies&rft_val_fmt=info:ofi/fmt:kev:mtx:journal&rfr_id=info:sid/primo.exlibrisgroup.com:primo-dedupmrg49102228",Journal | Social and Economic Studies |  | ISSN:0037-7651 | undefined,7,2,1,9,8,17,53,47,0,0,0,0,0
"getit.library.nyu.edu/resolve?umlaut.referent_id=18593227&url_ver=Z39.88-2004&url_ctx_fmt=info:ofi/fmt:kev:mtx:ctx&ctx_ver=Z39.88-2004&ctx_tim=2021-09-28T21:24:00-04:00&ctx_id=&ctx_enc=info:ofi/enc:UTF-8&rft.private_data=<nyu_aleph>000246778</nyu_aleph><grp_id>52406139</grp_id><oa></oa>&rft.genre=journal&rft.issn=00086495&rft.jtitle=Caribbean+Quarterly&rft.language=eng&rft.lccn=++2011235739&rft.object_id=110978976775255&rft.object_type=JOURNAL&rft.place=Mona,+Jamaica?]&rft.primo=dedupmrg49129157&rft.pub=Extra+Mural+Dept.+of+the+University+College+of+the+West+Indies&rft.title=Caribbean+Quarterly&rft_val_fmt=info:ofi/fmt:kev:mtx:journal&rfr_id=info:sid/primo.exlibrisgroup.com:primo-dedupmrg49129157",Journal | Caribbean Quarterly |  | ISSN:0008-6495 | undefined,8,2,1,10,9,19,53,47,0,0,0,0,0
"getit.library.nyu.edu/resolve?umlaut.referent_id=18598205&url_ver=Z39.88-2004&url_ctx_fmt=info:ofi/fmt:kev:mtx:ctx&ctx_ver=Z39.88-2004&ctx_tim=2021-10-04T11:54:32-04:00&ctx_id=&ctx_enc=info:ofi/enc:UTF-8&rft.au=Tsing,+Anna+Lowenhaupt&rft.aufirst=Anna+Lowenhaupt,&rft.auinitm=L&rft.aulast=Tsing&rft.btitle=The+Mushroom+at+the+End+of+the+World+:+On+the+Possibility+of+Life+in+Capitalist+Ruins&rft.date=2015&rft.eisbn=1-4008-7354-1&rft.eissn=9780691162751&rft.genre=book&rft.isbn=9781400873548&rft.isbn_additional=978-0-691-17832-5&rft.language=eng&rft.lccn=2014037624&rft.object_id=3810000000018925&rft.oclcnum=919876389&rft.primo=dedupmrg375024072&rft.private_data=<ERESDSB>000044860</ERESDSB><grp_id>395550787</grp_id><oa></oa><url></url>&rft.pub=Princeton+University+Press&rft.title=The+Mushroom+at+the+End+of+the+World+:+On+the+Possibility+of+Life+in+Capitalist+Ruins&rft.tpages=352&rft_val_fmt=info:ofi/fmt:kev:mtx:book&rfr_id=info:sid/primo.exlibrisgroup.com:primo-dedupmrg375024072",Book | The mushroom at the end of the world on the possibility of life in capitalist ruins | Tsing Anna Lowenhaupt 2015 |  | Publisher:Princeton University Press ISBN:9781400873548,0,0,6,0,6,6,0,100,0,0,0,0,0
"getit.library.nyu.edu/resolve?umlaut.referent_id=18602540&url_ver=Z39.88-2004&url_ctx_fmt=info:ofi/fmt:kev:mtx:ctx&ctx_ver=Z39.88-2004&ctx_tim=2021-10-04T00:46:51-04:00&ctx_id=&ctx_enc=info:ofi/enc:UTF-8&rft.btitle=More+math+into+LaTeX&rft.date=2007&rft.eisbn=0-387-68852-8&rft.eissn=9780387322896+0387322892&rft.genre=book&rft.isbn=9780387688527&rft.language=eng&rft.object_id=1000000000409762&rft.oclcnum=184985019&rft.place=New+York&rft.primo=dedupmrg331725011&rft.private_data=<nyu_aleph>004341400</nyu_aleph><grp_id>388958577</grp_id><oa></oa>&rft.pub=Springer&rft.stitle=LATEX+BOOK&rft.title=More+math+into+LaTeX&rft.tpages=620&rft.au=Gratzer,+George+A&rft.aulast=Gratzer&rft.aufirst=George+A.&rft.auinitm=A&rft_val_fmt=info:ofi/fmt:kev:mtx:book&rfr_id=info:sid/primo.exlibrisgroup.com:primo-dedupmrg331725011",Book | More Math Into Latex | Gratzer George A 2007 |  | Publisher:Springer New York ISBN:9780387688527,0,0,2,0,2,2,0,100,0,0,0,0,0
"getit.library.nyu.edu/resolve?umlaut.referent_id=18605020&url_ver=Z39.88-2004&url_ctx_fmt=info:ofi/fmt:kev:mtx:ctx&ctx_ver=Z39.88-2004&ctx_tim=2021-10-06T10:17:39-04:00&ctx_id=&ctx_enc=info:ofi/enc:UTF-8&rft.au=Ge\u0301ron,+Aure\u0301lien,+author&rft.aufirst=Aure\u0301lien,&rft.aulast=Ge\u0301ron&rft.btitle=Hands-on+machine+learning+with+Scikit-Learn+and+TensorFlow+:+concepts,+tools,+and+techniques+to+build+intelligent+systems&rft.date=2017&rft.genre=book&rft.isbn=9781491962244&rft.oclcnum=978351632&rft.primo=nyu_aleph005835977&rft.private_data=<nyu_aleph>005835977</nyu_aleph><grp_id>486247309</grp_id><oa></oa><url></url>&rft.pub=\",Book | Hands-on machine learning with Scikit-Learn and TensorFlow concepts tools and techniques to build intelligent systems | Géron Aurélien 2017 |  | Publisher ISBN:9781491962244,0,0,1,0,1,1,0,100,0,0,0,0,0
"getit.library.nyu.edu/resolve?umlaut.referent_id=18614129&url_ver=Z39.88-2004&url_ctx_fmt=info:ofi/fmt:kev:mtx:ctx&ctx_ver=Z39.88-2004&ctx_tim=2021-10-13T22:56:17-04:00&ctx_id=&ctx_enc=info:ofi/enc:UTF-8&rft.au=Butsch,+Richard&rft.aufirst=Richard,&rft.aulast=Butsch&rft.btitle=The+making+of+American+audiences+from+stage+to+television,+1750-1990&rft.date=2000&rft.eisbn=0-511-39518-3&rft.eisbn_additional=9786613437259&rft.eissn=0521662532+9780521662536+0521664837+9780521664837&rft.genre=book&rft.isbn=0511619715&rft.isbn_additional=978-0-521-66483-7&rft.language=eng&rft.lccn=99036490&rft.object_id=2560000000071407&rft.oclcnum=711906301&rft.place=Cambridge+;+New+York&rft.primo=dedupmrg492075512&rft.private_data=<nyu_aleph>005829119</nyu_aleph><grp_id>552898914</grp_id><oa></oa><url></url>&rft.pub=Cambridge+University+Press&rft.stitle=MAKING+OF+AMERICAN+AUDIENCES+:+FROM+STAGE+TO+TELEVISION,+1750-1990&rft.title=The+making+of+American+audiences+from+stage+to+television,+1750-1990&rft_val_fmt=info:ofi/fmt:kev:mtx:book&rfr_id=info:sid/primo.exlibrisgroup.com:primo-dedupmrg492075512",Book | The making of American audiences from stage to television 1750-1990 | Butsch Richard 2000 |  | Publisher:Cambridge University Press ISBN:0511619715,1,0,6,1,7,8,13,88,0,0,0,0,0
"getit.library.nyu.edu/resolve?umlaut.referent_id=18615912&url_ver=Z39.88-2004&url_ctx_fmt=info:ofi/fmt:kev:mtx:ctx&ctx_ver=Z39.88-2004&ctx_tim=2021-10-12T14:31:50-04:00&ctx_id=&ctx_enc=info:ofi/enc:UTF-8&rft.au=Buxton,+William&rft.aucorp=Buxton,+Bill&rft.aufirst=William.&rft.aulast=Buxton&rft.btitle=Sketching+user+experiences+:+getting+the+design+right+and+the+right+design&rft.date=2010&rft.eisbn=1-281-03308-1&rft.eisbn_additional=9786611033088&rft.eissn=9780123740373+0123740371&rft.genre=book&rft.isbn=9780080552903&rft.language=eng&rft.lccn=2006036416&rft.object_id=1000000000383564&rft.oclcnum=180932034&rft.place=Amsterdam+;+Boston&rft.primo=dedupmrg372555860&rft.private_data=<nyu_aleph>003690618</nyu_aleph><grp_id>430264436</grp_id><oa></oa><url></url>&rft.pub=Elsevier/Morgan+Kaufmann&rft.stitle=SKETCHING+USER+EXPERIENCE&rft.title=Sketching+user+experiences+:+getting+the+design+right+and+the+right+design&rft.tpages=448&rft_val_fmt=info:ofi/fmt:kev:mtx:book&rfr_id=info:sid/primo.exlibrisgroup.com:primo-dedupmrg372555860",Book | Sketching user experiences getting the design right and the right design | Buxton William 2010 |  | Publisher:Elsevier/Morgan Kaufmann ISBN:9780080552903,0,0,7,0,7,7,0,100,0,0,0,0,0
"getit.library.nyu.edu/resolve?umlaut.referent_id=18615912&url_ver=Z39.88-2004&url_ctx_fmt=info:ofi/fmt:kev:mtx:ctx&ctx_ver=Z39.88-2004&ctx_tim=2021-10-12T22:34:59-04:00&ctx_id=&ctx_enc=info:ofi/enc:UTF-8&rft.au=Buxton,+William&rft.aucorp=Buxton,+Bill&rft.aufirst=William.&rft.aulast=Buxton&rft.btitle=Sketching+user+experiences+:+getting+the+design+right+and+the+right+design&rft.date=2010&rft.eisbn=1-281-03308-1&rft.eisbn_additional=9786611033088&rft.eissn=9780123740373+0123740371&rft.genre=book&rft.isbn=9780080552903&rft.language=eng&rft.lccn=2006036416&rft.object_id=1000000000383564&rft.oclcnum=180932034&rft.place=Amsterdam+;+Boston&rft.primo=dedupmrg372555860&rft.private_data=<nyu_aleph>003690618</nyu_aleph><grp_id>430264436</grp_id><oa></oa><url></url>&rft.pub=Elsevier/Morgan+Kaufmann&rft.stitle=SKETCHING+USER+EXPERIENCE&rft.title=Sketching+user+experiences+:+getting+the+design+right+and+the+right+design&rft.tpages=448&rft_val_fmt=info:ofi/fmt:kev:mtx:book&rfr_id=info:sid/primo.exlibrisgroup.com:primo-dedupmrg372555860",Book | Sketching user experiences getting the design right and the right design | Buxton William 2010 |  | Publisher:Elsevier/Morgan Kaufmann ISBN:9780080552903,0,0,7,0,7,7,0,100,0,0,0,0,0
getit.library.nyu.edu/resolve?umlaut.referent_id=18616239&url_ver=Z39.88-2004&url_ctx_fmt=info:ofi/fmt:kev:mtx:ctx&ctx_ver=Z39.88-2004&ctx_tim=2021-10-10T09:26:52-04:00&ctx_id=&ctx_enc=info:ofi/enc:UTF-8&rft.jtitle=Journal+for+Islamic+Studies&rft_val_fmt=info:ofi/fmt:kev:mtx:journal&rfr_id=info:sid/umlaut.code4lib.org:opensearch,Journal | Journal for Islamic studies |  | ISSN:0257-7062 | undefined,0,0,4,0,4,4,0,100,0,0,0,0,0
"getit.library.nyu.edu/resolve?umlaut.referent_id=18622558&url_ver=Z39.88-2004&url_ctx_fmt=info:ofi/fmt:kev:mtx:ctx&ctx_ver=Z39.88-2004&ctx_tim=2021-10-12T16:38:57-04:00&ctx_id=&ctx_enc=info:ofi/enc:UTF-8&rft.btitle=Arguments+for+welfare+:+the+welfare+state+and+social+policy&rft.date=2017&rft.eisbn=1-78660-303-9&rft.eissn=9781786603012&rft.genre=book&rft.isbn=9781786603036&rft.language=eng&rft.lccn=2017009618&rft.object_id=3710000001151589&rft.place=London&rft.primo=nyu_aleph004989020&rft.private_data=<nyu_aleph>004989020</nyu_aleph><grp_id>458580561</grp_id><oa></oa><url></url>&rft.pub=Rowman+&+Littlefield+International=&rft.title=Arguments+for+welfare+:+the+welfare+state+and+social+policy&rft.au=Spicker,+Paul,+author&rft.aucorp=Spicker,+Paul&rft.aulast=Spicker&rft.aufirst=Paul,&rft_val_fmt=info:ofi/fmt:kev:mtx:book&rfr_id=info:sid/primo.exlibrisgroup.com:primo-nyu_aleph004989020",Book | Arguments for welfare the welfare state and social policy | Spicker Paul 2017 |  | Publisher:Rowman ISBN:9781786603036,0,0,1,0,1,1,0,100,0,0,0,0,0
"getit.library.nyu.edu/resolve?umlaut.referent_id=18627928&url_ver=Z39.88-2004&url_ctx_fmt=info:ofi/fmt:kev:mtx:ctx&ctx_ver=Z39.88-2004&ctx_tim=2021-10-15T20:48:42-04:00&ctx_id=&ctx_enc=info:ofi/enc:UTF-8&rft.au=Tsing,+Anna+Lowenhaupt&rft.aufirst=Anna+Lowenhaupt,&rft.auinitm=L&rft.aulast=Tsing&rft.btitle=The+Mushroom+at+the+End+of+the+World+:+On+the+Possibility+of+Life+in+Capitalist+Ruins&rft.date=2015&rft.eisbn=1-4008-7354-1&rft.eissn=9780691162751&rft.genre=book&rft.isbn=9781400873548&rft.isbn_additional=978-0-691-17832-5&rft.language=eng&rft.lccn=2014037624&rft.object_id=3810000000018925&rft.oclcnum=919876389&rft.primo=dedupmrg375024072&rft.private_data=<ERESDSB>000044860</ERESDSB><grp_id>395550787</grp_id><oa></oa><url></url>&rft.pub=Princeton+University+Press&rft.title=The+Mushroom+at+the+End+of+the+World+:+On+the+Possibility+of+Life+in+Capitalist+Ruins&rft.tpages=352&rft_val_fmt=info:ofi/fmt:kev:mtx:book&rfr_id=info:sid/primo.exlibrisgroup.com:primo-dedupmrg375024072",Book | The mushroom at the end of the world on the possibility of life in capitalist ruins | Tsing Anna Lowenhaupt 2015 |  | Publisher:Princeton University Press ISBN:9781400873548,0,0,6,0,6,6,0,100,0,0,0,0,0
"getit.library.nyu.edu/resolve?umlaut.referent_id=18631313&url_ver=Z39.88-2004&url_ctx_fmt=info:ofi/fmt:kev:mtx:ctx&ctx_ver=Z39.88-2004&ctx_tim=2021-10-16T23:27:10-04:00&ctx_id=&ctx_enc=info:ofi/enc:UTF-8&rft.btitle=Graphic+design+:+the+new+basics&rft.date=2015&rft.eisbn=1-61689-455-5&rft.eissn=9781568987705&rft.genre=book&rft.isbn=9781616894559&rft.isbn_additional=978-1-61689-325-5&rft.language=eng&rft.lccn=2014046286&rft.object_id=3710000000721136&rft.oclcnum=914231573&rft.place=New+York,+NY&rft.primo=dedupmrg418740973&rft.private_data=<nyu_aleph>004383181</nyu_aleph><grp_id>433310185</grp_id><oa></oa><url></url>&rft.pub=Princeton+Architectural+Press&rft.title=Graphic+design+:+the+new+basics&rft.tpages=264&rft.au=Lupton,+Ellen,+author&rft.aulast=Lupton&rft.aufirst=Ellen,&rft_val_fmt=info:ofi/fmt:kev:mtx:book&rfr_id=info:sid/primo.exlibrisgroup.com:primo-dedupmrg418740973",Book | Graphic design the new basics | Lupton Ellen 2015 |  | Publisher:Princeton Architectural Press ISBN:9781616894559,0,0,2,0,2,2,0,100,0,0,0,0,0
"getit.library.nyu.edu/resolve?umlaut.referent_id=18670428&url_ver=Z39.88-2004&url_ctx_fmt=info:ofi/fmt:kev:mtx:ctx&ctx_ver=Z39.88-2004&ctx_tim=2021-11-04T11:46:53-04:00&ctx_id=&ctx_enc=info:ofi/enc:UTF-8&rft.private_data=<nyu_aleph>003341815</nyu_aleph>&rft.btitle=Film+preservation+:+competing+definitions+of+value,+use,+and+practice&rft.genre=book&rft.isbn=1931666245&rft.place=Chicago&rft.primo=nyu_aleph003341815&rft.pub=The+Society+of+American+Archivists&rft.au=Gracy,+Karen+F&rft.aulast=Gracy&rft.aufirst=Karen+F.&rft_val_fmt=info:ofi/fmt:kev:mtx:book&rfr_id=info:sid/primo.exlibrisgroup.com:primo-nyu_aleph003341815",Book | Film preservation competing definitions of value use and practice | Gracy Karen F 2007 |  | Publisher:The Society of American Archivists ISBN:1931666245,0,0,2,0,2,2,0,100,0,0,0,0,0
"getit.library.nyu.edu/resolve?umlaut.referent_id=18673086&url_ver=Z39.88-2004&url_ctx_fmt=info:ofi/fmt:kev:mtx:ctx&ctx_ver=Z39.88-2004&ctx_tim=2021-11-05T18:09:13-04:00&ctx_id=&ctx_enc=info:ofi/enc:UTF-8&rft.btitle=Write+your+business+plan+:+get+your+plan+in+place+and+your+business+off+the+ground&rft.date=2015&rft.eisbn=1-61308-301-7&rft.eissn=9781599185576&rft.genre=book&rft.isbn=9781613083017&rft.language=eng&rft.object_id=3710000000279378&rft.oclcnum=910244988&rft.place=New+York&rft.primo=nyu_aleph005925403&rft.private_data=<nyu_aleph>005925403</nyu_aleph><grp_id>601123823</grp_id><oa></oa><url></url>&rft.pub=Entrepreneur+Press&rft.title=Write+your+business+plan+:+get+your+plan+in+place+and+your+business+off+the+ground&rft.tpages=394&rft.au=The+Staff+of+Entrepreneur+Media,+Inc&rft.aulast=The+Staff+of+Entrepreneur+Media&rft.aufirst=Inc&rft_val_fmt=info:ofi/fmt:kev:mtx:book&rfr_id=info:sid/primo.exlibrisgroup.com:primo-nyu_aleph005925403",Book | Write your business plan get your plan in place and your business off the ground | The Staff of Entrepreneur Media Inc 2015 |  | Publisher:Entrepreneur Press ISBN:9781613083017,0,0,2,0,2,2,0,100,0,0,0,0,0
"getit.library.nyu.edu/resolve?umlaut.referent_id=18708595&url_ver=Z39.88-2004&url_ctx_fmt=info:ofi/fmt:kev:mtx:ctx&ctx_ver=Z39.88-2004&ctx_tim=2021-11-22T09:02:42-05:00&ctx_id=&ctx_enc=info:ofi/enc:UTF-8&rft.atitle=Open+arms,+conflicted+hearts:+nurse\u2010practitioner's+attitudes+towards+working+with+lesbian,+gay+and+bisexual+patients&rft.au=Dorsen,&rft.auinit=C&rft.aulast=Dorsen&rft.coden=JCCNEW&rft.date=2016&rft.doi=10.1111/jocn.13464&rft.eissn=1365-2702&rft.epage=3727&rft.genre=article&rft.issn=0962-1067&rft.issue=23-24&rft.issue_end=24&rft.issue_start=23&rft.jtitle=Journal+of+Clinical+Nursing&rft.language=eng&rft.lccn=sn+92002492+&rft.month=12&rft.object_id=954925580117&rft.oclcnum=25492708&rft.place=ENGLAND&rft.pub=Blackwell+Scientific+Publications&rft.spage=3716&rft.stitle=J+CLIN+NURS&rft.title=Journal+of+Clinical+Nursing&rft.volume=25&rft.volume_start=25&rft_val_fmt=info:ofi/fmt:kev:mtx:journal&rft_id=info:doi/10.1111/jocn.13464&rfr_id=info:sid/google",Article | Open arms conflicted hearts nurse\u2010practitioner's attitudes towards working with lesbian gay and bisexual patients | Dorsen 2016 | Published in Journal Journal of Clinical Nursing Volume 25 Issue 23-24 Page 3716 3727. | ISSN:0962-1067,1,0,0,1,1,2,50,50,0,0,0,0,0
"getit.library.nyu.edu/resolve?umlaut.referent_id=18709545&url_ver=Z39.88-2004&url_ctx_fmt=info:ofi/fmt:kev:mtx:ctx&ctx_ver=Z39.88-2004&ctx_tim=2021-11-22T11:16:56-05:00&ctx_id=&ctx_enc=info:ofi/enc:UTF-8&rft.atitle=The+preservation+of+historic+architecture+:+the+U.S.+government's+official+guidelines+for+preserving+historic+homes&rft.btitle=The+preservation+of+historic+architecture+:+the+U.S.+government's+official+guidelines+for+preserving+historic+homes&rft.date=20040101&rft.day=1&rft.genre=article&rft.isbn=1592281265&rft.issn=15922812&rft.month=1&rft.oclcnum=54109389&rft.place=Guilford,+CT&rft.private_data=United+States.+Office+of+Archeology+and+Historic+Preservation.+Technical+Preservation+Services+Divisionedshtl.MIU01.00435940220040101HathiTrust&rft.pub=Lyons+Press&rft.title=The+preservation+of+historic+architecture+:+the+U.S.+government's+official+guidelines+for+preserving+historic+homes&rft.tpages=532&rft.au=United+States.+Office+of+Archeology+and+Historic+Preservation.+Technical+Preservation+Services+Division,&rft.aulast=United+States.+Office+of+Archeology+and+Historic+Preservation.+Technical+Preservation+Services+Division&rft_val_fmt=info:ofi/fmt:kev:mtx:journal&rfr_id=info:sid/EBSCO:HathiTrust",Article | The preservation of historic architecture the U.S government's official guidelines for preserving historic homes | United States Office of Archeology and Historic Preservation Technical Preservation Services Division 2004 Jan 01 | Published in Journal The preservation of historic architecture the U.S government's official guidelines for preserving historic homes. | ISSN:1592-2812 ISBN:1592281265,0,0,2,0,2,2,0,100,0,0,0,0,0
"getit.library.nyu.edu/resolve?umlaut.referent_id=18741056&url_ver=Z39.88-2004&url_ctx_fmt=info:ofi/fmt:kev:mtx:ctx&ctx_ver=Z39.88-2004&ctx_tim=2021-12-07T09:31:32-05:00&ctx_id=&ctx_enc=info:ofi/enc:UTF-8&rft.btitle=The+Mushroom+at+the+End+of+the+World+:+On+the+Possibility+of+Life+in+Capitalist+Ruins&rft.date=2015&rft.eisbn=1-4008-7354-1&rft.eissn=9780691162751&rft.genre=book&rft.isbn=9781400873548&rft.language=eng&rft.object_id=3810000000018925&rft.oclcnum=919876389&rft.primo=dedupmrg375024072&rft.private_data=<ERESDSB>000044860</ERESDSB><grp_id>395550787</grp_id><oa></oa><url></url>&rft.pub=Princeton+University+Press&rft.title=The+Mushroom+at+the+End+of+the+World+:+On+the+Possibility+of+Life+in+Capitalist+Ruins&rft.tpages=352&rft.au=Tsing,+Anna+Lowenhaupt,+author&rft.aulast=Tsing&rft.aufirst=Anna+Lowenhaupt,&rft.auinitm=L&rft_val_fmt=info:ofi/fmt:kev:mtx:book&rfr_id=info:sid/primo.exlibrisgroup.com:primo-dedupmrg375024072",Book | The mushroom at the end of the world on the possibility of life in capitalist ruins | Tsing Anna Lowenhaupt 2015 |  | Publisher:Princeton University Press ISBN:9781400873548,0,0,6,0,6,6,0,100,0,0,0,0,0
"getit.library.nyu.edu/resolve?umlaut.referent_id=18741619&url_ver=Z39.88-2004&url_ctx_fmt=info:ofi/fmt:kev:mtx:ctx&ctx_ver=Z39.88-2004&ctx_tim=2021-12-07T12:55:12-05:00&ctx_id=&ctx_enc=info:ofi/enc:UTF-8&rft.btitle=Handbook+of+development+economics&rft.date=1988&rft.genre=book&rft.isbn=0444703373&rft.language=eng&rft.lccn=87034960&rft.object_id=2630000000000100&rft.place=Amsterdam+;+New+York+:+New+York,+N.Y.,+U.S.A.&rft.primo=dedupmrg40069516&rft.private_data=<wccselsevier>ocn551342085</wccselsevier><grp_id>112151153</grp_id><oa></oa>&rft.pub=North-Holland+;+Sole+distributors+for+the+U.S.A.+and+Canada,+Elsevier+Science+Pub.+Co.&rft.stitle=HANDBOOK+OF+DEVELOPMENT+ECONOMICS&rft.title=Handbook+of+development+economics&rft.tpages=882&rft.au=Hollis+Burnley+Chenery&rft.aulast=Chenery&rft.aufirst=Hollis+Burnley&rft.auinitm=B&rft_val_fmt=info:ofi/fmt:kev:mtx:book&rfr_id=info:sid/primo.exlibrisgroup.com:primo-dedupmrg40069516",Book | Handbook of development economics | Hollis Burnley Chenery 1988 |  | Publisher:North-Holland Sole distributors for the U.S.A and Canada Elsevier Science Pub Co ISBN:0444703373,0,0,1,0,1,1,0,100,0,0,0,0,0
"getit.library.nyu.edu/resolve?umlaut.referent_id=18762937&url_ver=Z39.88-2004&url_ctx_fmt=info:ofi/fmt:kev:mtx:ctx&ctx_ver=Z39.88-2004&ctx_tim=2021-12-16T21:17:13-05:00&ctx_id=&ctx_enc=info:ofi/enc:UTF-8&rft.au=Ge\u0301ron,+Aure\u0301lien,+author&rft.aufirst=Aure\u0301lien,&rft.aulast=Ge\u0301ron&rft.btitle=Hands-on+machine+learning+with+Scikit-Learn+and+TensorFlow+:+concepts,+tools,+and+techniques+to+build+intelligent+systems&rft.date=2017&rft.genre=book&rft.isbn=9781491962244&rft.oclcnum=978351632&rft.primo=nyu_aleph005835977&rft.private_data=<nyu_aleph>005835977</nyu_aleph><grp_id>486247309</grp_id><oa></oa><url></url>&rft.pub=\",Book | Hands-on machine learning with Scikit-Learn and TensorFlow concepts tools and techniques to build intelligent systems | Géron Aurélien 2017 |  | Publisher ISBN:9781491962244,0,0,1,0,1,1,0,100,0,0,0,0,0
"getit.library.nyu.edu/resolve?umlaut.referent_id=18769959&url_ver=Z39.88-2004&url_ctx_fmt=info:ofi/fmt:kev:mtx:ctx&ctx_ver=Z39.88-2004&ctx_tim=2021-12-22T08:22:11-05:00&ctx_id=&ctx_enc=info:ofi/enc:UTF-8&rft.au=Jacobsen,+Thorkild&rft.aucorp=THORKILD+JACOBSEN&rft.aufirst=Thorkild,&rft.aulast=Jacobsen&rft.btitle=The+Harps+that+once--+:+Sumerian+poetry+in+translation&rft.date=1987&rft.eisbn=0-300-16187-5&rft.eissn=0300039069&rft.genre=book&rft.isbn=9780300161878&rft.language=eng&rft.lccn=87010559&rft.object_id=3360000000476265&rft.oclcnum=jst861792476&rft.place=New+Haven+;+London&rft.primo=dedupmrg374027928&rft.private_data=<nyu_aleph>005785687</nyu_aleph><grp_id>433402477</grp_id><oa></oa><url></url>&rft.pub=Yale+University+Press&rft.title=The+Harps+that+once--+:+Sumerian+poetry+in+translation&rft_val_fmt=info:ofi/fmt:kev:mtx:book&rfr_id=info:sid/primo.exlibrisgroup.com:primo-dedupmrg374027928",Book | The Harps that once Sumerian poetry in translation | Jacobsen Thorkild 1987 |  | Publisher:Yale University Press ISBN:9780300161878,0,0,2,0,2,2,0,100,0,0,0,0,0
"getit.library.nyu.edu/resolve?umlaut.referent_id=18771190&url_ver=Z39.88-2004&url_ctx_fmt=info:ofi/fmt:kev:mtx:ctx&ctx_ver=Z39.88-2004&ctx_tim=2021-12-22T17:10:51-05:00&ctx_id=&ctx_enc=info:ofi/enc:UTF-8&rft.btitle=The+Mushroom+at+the+End+of+the+World+:+On+the+Possibility+of+Life+in+Capitalist+Ruins&rft.date=2015&rft.eisbn=1-4008-7354-1&rft.eissn=9780691162751&rft.genre=book&rft.isbn=9781400873548&rft.language=eng&rft.object_id=3810000000018925&rft.oclcnum=919876389&rft.primo=dedupmrg375024072&rft.private_data=<ERESDSB>000044860</ERESDSB><grp_id>395550787</grp_id><oa></oa><url></url>&rft.pub=Princeton+University+Press&rft.title=The+Mushroom+at+the+End+of+the+World+:+On+the+Possibility+of+Life+in+Capitalist+Ruins&rft.tpages=352&rft.au=Tsing,+Anna+Lowenhaupt,+author&rft.aulast=Tsing&rft.aufirst=Anna+Lowenhaupt,&rft.auinitm=L&rft_val_fmt=info:ofi/fmt:kev:mtx:book&rfr_id=info:sid/primo.exlibrisgroup.com:primo-dedupmrg375024072",Book | The mushroom at the end of the world on the possibility of life in capitalist ruins | Tsing Anna Lowenhaupt 2015 |  | Publisher:Princeton University Press ISBN:9781400873548,0,0,6,0,6,6,0,100,0,0,0,0,0
"getit.library.nyu.edu/resolve?umlaut.referent_id=18785473&url_ver=Z39.88-2004&url_ctx_fmt=info:ofi/fmt:kev:mtx:ctx&ctx_ver=Z39.88-2004&ctx_tim=2022-01-13T07:55:37-05:00&ctx_id=&ctx_enc=info:ofi/enc:UTF-8&rft.au=Ge\u0301ron,+Aure\u0301lien,+author&rft.aufirst=Aure\u0301lien,&rft.aulast=Ge\u0301ron&rft.btitle=Hands-on+machine+learning+with+Scikit-Learn+and+TensorFlow+:+concepts,+tools,+and+techniques+to+build+intelligent+systems&rft.date=2017&rft.genre=book&rft.isbn=9781491962244&rft.oclcnum=978351632&rft.primo=nyu_aleph005835977&rft.private_data=<nyu_aleph>005835977</nyu_aleph><grp_id>486247309</grp_id><oa></oa><url></url>&rft.pub=\",Book | Hands-on machine learning with Scikit-Learn and TensorFlow concepts tools and techniques to build intelligent systems | Géron Aurélien 2017 |  | Publisher ISBN:9781491962244,0,0,1,0,1,1,0,100,0,0,0,0,0
getit.library.nyu.edu/resolve?umlaut.referent_id=18789826&url_ver=Z39.88-2004&url_ctx_fmt=info:ofi/fmt:kev:mtx:ctx&ctx_ver=Z39.88-2004&ctx_tim=2022-01-17T18:20:06-05:00&ctx_id=&ctx_enc=info:ofi/enc:UTF-8&rft.jtitle=Journal+for+Islamic+Studies&rft_val_fmt=info:ofi/fmt:kev:mtx:journal&rfr_id=info:sid/umlaut.code4lib.org:opensearch,Journal | Journal for Islamic studies |  | ISSN:0257-7062 | undefined,1,0,3,1,4,5,20,80,0,0,0,0,0
"getit.library.nyu.edu/resolve?umlaut.referent_id=18790302&url_ver=Z39.88-2004&url_ctx_fmt=info:ofi/fmt:kev:mtx:ctx&ctx_ver=Z39.88-2004&ctx_tim=2022-01-18T10:00:01-05:00&ctx_id=&ctx_enc=info:ofi/enc:UTF-8&rft.au=Troutt+Powell,+Eve&rft.aufirst=Eve.&rft.aulast=Troutt+Powell&rft.btitle=Tell+This+in+My+Memory+:+Stories+of+Enslavement+from+Egypt,+Sudan,+and+the+Ottoman+Empire.&rft.date=2012&rft.eisbn=0-8047-8375-6&rft.eissn=9780804782333&rft.genre=book&rft.isbn=9780804783750&rft.language=eng&rft.object_id=2670000000299044&rft.oclcnum=823380545&rft.place=Palo+Alto&rft.primo=nyu_aleph003937209&rft.private_data=<nyu_aleph>003937209</nyu_aleph><grp_id>537396145</grp_id><oa></oa><url></url>&rft.pub=Stanford+University+Press&rft.title=Tell+This+in+My+Memory+:+Stories+of+Enslavement+from+Egypt,+Sudan,+and+the+Ottoman+Empire.&rft.tpages=264&rft_val_fmt=info:ofi/fmt:kev:mtx:book&rfr_id=info:sid/primo.exlibrisgroup.com:primo-nyu_aleph003937209",Book | Tell This in My Memory Stories of Enslavement from Egypt Sudan and the Ottoman Empire. | Troutt Powell Eve 2012 |  | Publisher:Stanford University Press ISBN:9780804783750,0,0,4,0,4,4,0,100,0,0,0,0,0
getit.library.nyu.edu/resolve?umlaut.referent_id=18793671&url_ver=Z39.88-2004&url_ctx_fmt=info:ofi/fmt:kev:mtx:ctx&ctx_ver=Z39.88-2004&ctx_tim=2022-01-21T00:41:28-05:00&ctx_id=&ctx_enc=info:ofi/enc:UTF-8&rft.jtitle=Journal+for+Islamic+Studies&rft_val_fmt=info:ofi/fmt:kev:mtx:journal&rfr_id=info:sid/umlaut.code4lib.org:opensearch,Journal | Journal for Islamic studies |  | ISSN:0257-7062 | undefined,1,0,3,1,4,5,20,80,0,0,0,0,0
"getit.library.nyu.edu/resolve?umlaut.referent_id=18795006&url_ver=Z39.88-2004&url_ctx_fmt=info:ofi/fmt:kev:mtx:ctx&ctx_ver=Z39.88-2004&ctx_tim=2022-01-22T16:58:20-05:00&ctx_id=&ctx_enc=info:ofi/enc:UTF-8&rft.au=Jacobsen,+Thorkild&rft.aucorp=THORKILD+JACOBSEN&rft.aufirst=Thorkild,&rft.aulast=Jacobsen&rft.btitle=The+Harps+that+once--+:+Sumerian+poetry+in+translation&rft.date=1987&rft.eisbn=0-300-16187-5&rft.eissn=0300039069&rft.genre=book&rft.isbn=9780300161878&rft.language=eng&rft.lccn=87010559&rft.object_id=3360000000476265&rft.oclcnum=jst861792476&rft.place=New+Haven+;+London&rft.primo=dedupmrg374027928&rft.private_data=<nyu_aleph>005785687</nyu_aleph><grp_id>433402477</grp_id><oa></oa><url></url>&rft.pub=Yale+University+Press&rft.title=The+Harps+that+once--+:+Sumerian+poetry+in+translation&rft_val_fmt=info:ofi/fmt:kev:mtx:book&rfr_id=info:sid/primo.exlibrisgroup.com:primo-dedupmrg374027928",Book | The Harps that once Sumerian poetry in translation | Jacobsen Thorkild 1987 |  | Publisher:Yale University Press ISBN:9780300161878,0,0,2,0,2,2,0,100,0,0,0,0,0
getit.library.nyu.edu/resolve?umlaut.referent_id=18795874&url_ver=Z39.88-2004&url_ctx_fmt=info:ofi/fmt:kev:mtx:ctx&ctx_ver=Z39.88-2004&ctx_tim=2022-01-24T14:56:40-05:00&ctx_id=&ctx_enc=info:ofi/enc:UTF-8&rft.au=Richard+T.+LeGates&rft.aufirst=Richard+T.&rft.aulast=LeGates&rft.btitle=The+city+reader&rft.date=2011&rft.eisbn=0-203-86926-5&rft.eisbn_additional=9786613045386&rft.genre=book&rft.isbn=9780415556644&rft.isbn_additional=978-0-415-55664-4&rft.language=eng&rft.lccn=2010027851&rft.object_id=2560000000061550&rft.oclcnum=712654434&rft.place=London+;+New+York&rft.primo=dedupmrg52787609&rft.pub=Routledge&rft.stitle=CITY+READER+:+ROUTLEDGE+URBAN+READER+SERIES&rft.title=The+city+reader&rft.tpages=624&rft_val_fmt=info:ofi/fmt:kev:mtx:book&rfr_id=info:sid/primo.exlibrisgroup.com:primo-dedupmrg52787609,Book | The city reader | Richard T LeGates 2011 |  | Publisher:Routledge ISBN:9780415556644,0,0,1,0,1,1,0,100,0,0,0,0,0
getit.library.nyu.edu/resolve?umlaut.referent_id=18795874&url_ver=Z39.88-2004&url_ctx_fmt=info:ofi/fmt:kev:mtx:ctx&ctx_ver=Z39.88-2004&ctx_tim=2022-01-26T16:23:03-05:00&ctx_id=&ctx_enc=info:ofi/enc:UTF-8&rft.au=Richard+T.+LeGates&rft.aufirst=Richard+T.&rft.aulast=LeGates&rft.btitle=The+city+reader&rft.date=2011&rft.eisbn=0-203-86926-5&rft.eisbn_additional=9786613045386&rft.genre=book&rft.isbn=9780415556644&rft.isbn_additional=978-0-415-55664-4&rft.language=eng&rft.lccn=2010027851&rft.object_id=2560000000061550&rft.oclcnum=712654434&rft.place=London+;+New+York&rft.primo=dedupmrg52787609&rft.pub=Routledge&rft.stitle=CITY+READER+:+ROUTLEDGE+URBAN+READER+SERIES&rft.title=The+city+reader&rft.tpages=624&rft_val_fmt=info:ofi/fmt:kev:mtx:book&rfr_id=info:sid/primo.exlibrisgroup.com:primo-dedupmrg52787609,Book | The city reader | Richard T LeGates 2011 |  | Publisher:Routledge ISBN:9780415556644,0,0,1,0,1,1,0,100,0,0,0,0,0
"getit.library.nyu.edu/resolve?umlaut.referent_id=18798093&url_ver=Z39.88-2004&url_ctx_fmt=info:ofi/fmt:kev:mtx:ctx&ctx_ver=Z39.88-2004&ctx_tim=2022-01-24T17:44:17-05:00&ctx_id=&ctx_enc=info:ofi/enc:UTF-8&rft.btitle=The+visual+story+creating+the+visual+structure+of+film,+tv+and+digital+media&rft.date=2007&rft.eisbn=1-281-05485-2&rft.eisbn_additional=9786611054854&rft.eissn=9780240807799+0240807790&rft.genre=book&rft.isbn=9780080551692&rft.isbn_additional=978-1-138-41062-6&rft.language=eng&rft.object_id=1000000000407841&rft.oclcnum=179474057&rft.place=Amsterdam+;+Boston&rft.primo=dedupmrg493217036&rft.private_data=<nyu_aleph>004174491</nyu_aleph><grp_id>553362961</grp_id><oa></oa><url></url>&rft.pub=Elsevier/Focal+Press&rft.stitle=VISUAL+STORY+:+CREATING+VISUAL+STRUCTURE+IN+FILM,+TELEVISION,+AND+NEW+MEDIA&rft.title=The+visual+story+creating+the+visual+structure+of+film,+tv+and+digital+media&rft.au=Block,+Bruce&rft.aulast=Block&rft.aufirst=Bruce.&rft.auinitm=A&rft_val_fmt=info:ofi/fmt:kev:mtx:book&rfr_id=info:sid/primo.exlibrisgroup.com:primo-dedupmrg493217036",Book | The visual story creating the visual structure of film TV and digital media | Block Bruce A 2007 |  | Publisher:Focal Press/Elsevier ISBN:9780080551692,0,0,2,0,2,2,0,100,0,0,0,0,0
"getit.library.nyu.edu/resolve?umlaut.referent_id=18798483&url_ver=Z39.88-2004&url_ctx_fmt=info:ofi/fmt:kev:mtx:ctx&ctx_ver=Z39.88-2004&ctx_tim=2022-01-25T18:48:26-05:00&ctx_id=&ctx_enc=info:ofi/enc:UTF-8&rft.au=Schuiling,+Kerri+Durnell&rft.aucorp=Schuiling,+Kerri+Durnell;+Likis,+Frances+E.&rft.aufirst=Kerri+Durnell.&rft.auinitm=D&rft.aulast=Schuiling&rft.btitle=Women's+Gynecologic+Health.&rft.date=2016&rft.eisbn=1-284-07604-0&rft.eissn=9781284076028&rft.genre=book&rft.isbn=9781284076042&rft.language=eng&rft.object_id=3710000000824415&rft.oclcnum=960760569&rft.primo=nyu_aleph004680328&rft.private_data=<nyu_aleph>004680328</nyu_aleph><grp_id>430825467</grp_id><oa></oa><url></url>&rft.pub=Jones+&+Bartlett+Learning=&rft.title=Women's+Gynecologic+Health.&rft_val_fmt=info:ofi/fmt:kev:mtx:book&rfr_id=info:sid/primo.exlibrisgroup.com:primo-nyu_aleph004680328",Book | Women's Gynecologic Health. | Schuiling Kerri Durnell 2016 |  | Publisher:Jones Bartlett Learning ISBN:9781284076042,0,0,1,0,1,1,0,100,0,0,0,0,0
"getit.library.nyu.edu/resolve?umlaut.referent_id=18798746&url_ver=Z39.88-2004&url_ctx_fmt=info:ofi/fmt:kev:mtx:ctx&ctx_ver=Z39.88-2004&ctx_tim=2022-01-25T13:16:30-05:00&ctx_id=&ctx_enc=info:ofi/enc:UTF-8&rft.au=Cicero,+Marcus+Tullius&rft.aucorp=Powell,+Jonathan&rft.aufirst=Marcus+Tullius,&rft.auinitm=T&rft.aulast=Cicero&rft.btitle=The+republic+:+and,+the+laws&rft.date=1998&rft.eisbn=0-19-183841-1&rft.eisbn_additional=978-0-19-159356-7&rft.eissn=0192832360&rft.genre=book&rft.isbn=9780191593567&rft.isbn_additional=978-0-19-954011-2&rft.language=eng&rft.lccn=97023394&rft.object_id=111004366524650&rft.oclcnum=44963338&rft.place=Oxford&rft.primo=dedupmrg492058377&rft.private_data=<nyu_aleph>004774783</nyu_aleph><grp_id>534855026</grp_id><oa></oa><url></url>&rft.pub=Oxford+University+Press&rft.stitle=REPUBLIC&rft.title=The+republic+:+and,+the+laws&rft.tpages=242&rft_val_fmt=info:ofi/fmt:kev:mtx:book&rfr_id=info:sid/primo.exlibrisgroup.com:primo-dedupmrg492058377",Book | The republic and the laws | Cicero Marcus Tullius 1998 |  | Publisher:Oxford University Press ISBN:9780191593567,0,0,2,0,2,2,0,100,0,0,0,0,0
"getit.library.nyu.edu/resolve?umlaut.referent_id=18803100&url_ver=Z39.88-2004&url_ctx_fmt=info:ofi/fmt:kev:mtx:ctx&ctx_ver=Z39.88-2004&ctx_tim=2022-01-28T10:29:42-05:00&ctx_id=&ctx_enc=info:ofi/enc:UTF-8&rft.btitle=On+sovereignty+four+chapters+from+the+six+books+of+the+commonwealth&rft.date=1992&rft.eisbn=0-511-80281-1&rft.eissn=0521342066+9780521342063+0521349923+9780521349925&rft.genre=book&rft.isbn=0511802811&rft.isbn_additional=978-0-521-34992-5&rft.language=eng&rft.object_id=2560000000091611&rft.place=Cambridge+[England]+;+New+York&rft.primo=nyu_aleph003984836&rft.private_data=<nyu_aleph>003984836</nyu_aleph><grp_id>429220781</grp_id><oa></oa><url></url>&rft.pub=Cambridge+University+Press&rft.title=On+sovereignty+four+chapters+from+the+six+books+of+the+commonwealth&rft.au=Bodin,+Jean,+1530-1596&rft.aucorp=Bodin,+Jean;+Franklin,+Julian+H.&rft.aulast=Bodin&rft.aufirst=Jean,&rft_val_fmt=info:ofi/fmt:kev:mtx:book&rfr_id=info:sid/primo.exlibrisgroup.com:primo-nyu_aleph003984836",Book | On sovereignty four chapters from the Six books of the commonwealth | Bodin Jean 1992 |  | Publisher:Cambridge University Press ISBN:0511802811,0,0,1,0,1,1,0,100,0,0,0,0,0
"getit.library.nyu.edu/resolve?umlaut.referent_id=18807569&url_ver=Z39.88-2004&url_ctx_fmt=info:ofi/fmt:kev:mtx:ctx&ctx_ver=Z39.88-2004&ctx_tim=2022-01-31T22:28:37-05:00&ctx_id=&ctx_enc=info:ofi/enc:UTF-8&rft.btitle=The+fundamentals+of+political+science+research&rft.eisbn=1-139-10425-X&rft.genre=book&rft.isbn=9781139104258&rft.language=eng&rft.object_id=2670000000361640&rft.place=Cambridge+;+New+York&rft.primo=nyu_aleph003784401&rft.private_data=<nyu_aleph>003784401</nyu_aleph><grp_id>65962761</grp_id><oa></oa>&rft.pub=Cambridge+University+Press&rft.title=The+fundamentals+of+political+science+research&rft.au=Kellstedt,+Paul+M.,+1968-&rft.aulast=Kellstedt&rft.aufirst=Paul+M.,&rft_val_fmt=info:ofi/fmt:kev:mtx:book&rfr_id=info:sid/primo.exlibrisgroup.com:primo-nyu_aleph003784401",Book | The fundamentals of political science research | Kellstedt Paul M 2013 |  | Publisher:Cambridge University Press ISBN:9781139104258,0,0,1,0,1,1,0,100,0,0,0,0,0
"getit.library.nyu.edu/resolve?umlaut.referent_id=18808747&url_ver=Z39.88-2004&url_ctx_fmt=info:ofi/fmt:kev:mtx:ctx&ctx_ver=Z39.88-2004&ctx_tim=2022-02-01T16:10:48-05:00&ctx_id=&ctx_enc=info:ofi/enc:UTF-8&rft.au=Best,+Joel&rft.aufirst=Joel.&rft.aulast=Best&rft.btitle=Damned+lies+and+statistics+untangling+numbers+from+the+media,+politicians,+and+activists&rft.date=2012&rft.eisbn=0-520-95351-7&rft.eisbn_additional=9786613906915&rft.eissn=9780520274709+0520274709&rft.genre=book&rft.isbn=0520953517&rft.language=eng&rft.object_id=2560000000092966&rft.place=Berkeley,+Calif.+;+London&rft.primo=nyu_aleph003696910&rft.private_data=<nyu_aleph>003696910</nyu_aleph><grp_id>61081812</grp_id><oa></oa><url></url>&rft.pub=University+of+California+Press&rft.title=Damned+lies+and+statistics+untangling+numbers+from+the+media,+politicians,+and+activists&rft.tpages=224&rft_val_fmt=info:ofi/fmt:kev:mtx:book&rfr_id=info:sid/primo.exlibrisgroup.com:primo-nyu_aleph003696910",Book | Damned lies and statistics untangling numbers from the media politicians and activists | Best Joel 2012 |  | Publisher:University of California Press ISBN:0520953517,1,0,10,1,11,12,8,92,0,0,0,0,0
"getit.library.nyu.edu/resolve?umlaut.referent_id=18812042&url_ver=Z39.88-2004&url_ctx_fmt=info:ofi/fmt:kev:mtx:ctx&ctx_ver=Z39.88-2004&ctx_tim=2022-02-04T10:02:53-05:00&ctx_id=&ctx_enc=info:ofi/enc:UTF-8&rft.au=Larusson,+Johann+Ari&rft.aufirst=Johann+Ari,&rft.auinitm=A&rft.aulast=Larusson&rft.btitle=Learning+analytics+:+from+research+to+practice&rft.date=2014&rft.eisbn=1-4614-3305-3&rft.eissn=9781461433040&rft.genre=book&rft.isbn=9781461433057&rft.isbn_additional=978-1-322-13243-3&rft.language=eng&rft.object_id=3710000000167934&rft.oclcnum=883201400&rft.primo=nyu_aleph004446367&rft.private_data=<nyu_aleph>004446367</nyu_aleph><grp_id>404163307</grp_id><oa></oa><url></url>&rft.pub=Springer+New+York&rft.title=Learning+analytics+:+from+research+to+practice&rft.tpages=195&rft_val_fmt=info:ofi/fmt:kev:mtx:book&rfr_id=info:sid/primo.exlibrisgroup.com:primo-nyu_aleph004446367",Book | Learning analytics from research to practice | Larusson Johann Ari 2014 |  | Publisher:Springer New York ISBN:9781461433057,0,0,3,0,3,3,0,100,0,0,0,0,0
getit.library.nyu.edu/resolve?umlaut.referent_id=18812956&url_ver=Z39.88-2004&url_ctx_fmt=info:ofi/fmt:kev:mtx:ctx&ctx_ver=Z39.88-2004&ctx_tim=2022-02-06T16:18:44-05:00&ctx_id=&ctx_enc=info:ofi/enc:UTF-8&rft.au=Richard+T.+LeGates&rft.aufirst=Richard+T.&rft.aulast=LeGates&rft.btitle=The+city+reader&rft.date=2011&rft.eisbn=0-203-86926-5&rft.eisbn_additional=9786613045386&rft.genre=book&rft.isbn=9780415556644&rft.isbn_additional=978-0-415-55664-4&rft.language=eng&rft.lccn=2010027851&rft.object_id=2560000000061550&rft.oclcnum=712654434&rft.place=London+;+New+York&rft.primo=dedupmrg52787609&rft.pub=Routledge&rft.stitle=CITY+READER+:+ROUTLEDGE+URBAN+READER+SERIES&rft.title=The+city+reader&rft.tpages=624&rft_val_fmt=info:ofi/fmt:kev:mtx:book&rfr_id=info:sid/primo.exlibrisgroup.com:primo-dedupmrg52787609,Book | The city reader | Richard T LeGates 2011 |  | Publisher:Routledge ISBN:9780415556644,0,0,1,0,1,1,0,100,0,0,0,0,0
"getit.library.nyu.edu/resolve?umlaut.referent_id=18815120&url_ver=Z39.88-2004&url_ctx_fmt=info:ofi/fmt:kev:mtx:ctx&ctx_ver=Z39.88-2004&ctx_tim=2022-02-07T17:19:24-05:00&ctx_id=&ctx_enc=info:ofi/enc:UTF-8&rft.atitle=Level+of+interactivity+and+executive+functions+as+predictors+of+learning+in+computer-based+chemistry+simulations&rft.au=Plass,+Jan+L.&rft.aufirst=Bruce+D.&rft.auinitm=D&rft.aulast=Homer&rft.coden=CHBEEQ&rft.date=2014&rft.doi=10.1016/j.chb.2014.03.041&rft.eissn=1873-7692&rft.epage=375&rft.genre=article&rft.issn=0747-5632&rft.jtitle=Computers+in+human+behavior&rft.language=eng&rft.lccn=++2003233319&rft.month=07&rft.object_id=954925542202&rft.oclcnum=10746756&rft.pages=365-375&rft.place=UNITED+STATES&rft.pub=Pergamon&rft.spage=365&rft.stitle=COMPUT+HUM+BEHAV&rft.title=Computers+in+human+behavior&rft.volume=36&rft.volume_start=36&rft_val_fmt=info:ofi/fmt:kev:mtx:journal&rft_id=info:doi/10.1016/j.chb.2014.03.041&rfr_id=info:sid/webofscience.com:WOS:WOS",Article | Level of interactivity and executive functions as predictors of learning in computer-based chemistry simulations | Plass Jan L 2014 | Published in Journal Computers in human behavior Volume 36 Page 365 375. | ISSN:0747-5632,1,0,0,1,1,2,50,50,0,0,0,0,0
"getit.library.nyu.edu/resolve?umlaut.referent_id=18819837&url_ver=Z39.88-2004&url_ctx_fmt=info:ofi/fmt:kev:mtx:ctx&ctx_ver=Z39.88-2004&ctx_tim=2022-02-08T16:32:33-05:00&ctx_id=&ctx_enc=info:ofi/enc:UTF-8&rft.private_data=<nyu_aleph>000246777</nyu_aleph><grp_id>52427906</grp_id><oa></oa>&rft.genre=journal&rft.issn=00377651&rft.jtitle=Social+and+Economic+Studies&rft.language=eng&rft.lccn=++2011234206&rft.object_id=960239073771&rft.object_type=JOURNAL&rft.place=Mona,+Jamaica&rft.primo=dedupmrg49102228&rft.pub=Institute+of+Social+and+Economic+Research&rft.stitle=SOC+ECON+STUD&rft.title=Social+and+Economic+Studies&rft_val_fmt=info:ofi/fmt:kev:mtx:journal&rfr_id=info:sid/primo.exlibrisgroup.com:primo-dedupmrg49102228",Journal | Social and Economic Studies |  | ISSN:0037-7651 | undefined,7,2,1,9,8,17,53,47,0,0,0,0,0
"getit.library.nyu.edu/resolve?umlaut.referent_id=18820226&url_ver=Z39.88-2004&url_ctx_fmt=info:ofi/fmt:kev:mtx:ctx&ctx_ver=Z39.88-2004&ctx_tim=2022-02-10T10:56:49-05:00&ctx_id=&ctx_enc=info:ofi/enc:UTF-8&rft.au=Zarinebaf,+F.+(Fariba)&rft.aucorp=Zarinebaf,+F&rft.aufirst=F.&rft.auinitm=F&rft.aulast=Zarinebaf&rft.btitle=Crime+and+punishment+in+Istanbul+:+1700/1800&rft.date=2011&rft.eisbn=0-520-94756-8&rft.eisbn_additional=9786613277305&rft.eissn=9780520262201&rft.genre=book&rft.isbn=9780520947566&rft.language=eng&rft.lccn=2010020820&rft.object_id=2670000000059715&rft.oclcnum=701053852&rft.place=Berkeley&rft.primo=dedupmrg491479160&rft.private_data=<nyu_aleph>003570251</nyu_aleph><grp_id>553296020</grp_id><oa></oa><url></url>&rft.pub=University+of+California+Press&rft.stitle=CRIME+AND+PUNISHMENT+IN+ISTANBUL&rft.title=Crime+and+punishment+in+Istanbul+:+1700/1800&rft.tpages=304&rft_val_fmt=info:ofi/fmt:kev:mtx:book&rfr_id=info:sid/primo.exlibrisgroup.com:primo-dedupmrg491479160",Book | Crime and punishment in Istanbul 1700/1800 | Zarinebaf F Fariba 2011 |  | Publisher:University of California Press ISBN:9780520947566,0,0,6,0,6,6,0,100,0,0,0,0,0
getit.library.nyu.edu/resolve?umlaut.referent_id=18824467&url_ver=Z39.88-2004&url_ctx_fmt=info:ofi/fmt:kev:mtx:ctx&ctx_ver=Z39.88-2004&ctx_tim=2022-02-11T10:11:17-05:00&ctx_id=&ctx_enc=info:ofi/enc:UTF-8&rft.jtitle=Holy+Land+Studies:+A+Multidisciplinary+Journal&rft_val_fmt=info:ofi/fmt:kev:mtx:journal&rfr_id=info:sid/umlaut.code4lib.org:opensearch,Journal | Journal of Holy Land and Palestine Studies |  | ISSN:2054-1988 | undefined,0,0,5,0,5,5,0,100,0,0,0,0,0
"getit.library.nyu.edu/resolve?umlaut.referent_id=18827639&url_ver=Z39.88-2004&url_ctx_fmt=info:ofi/fmt:kev:mtx:ctx&ctx_ver=Z39.88-2004&ctx_tim=2022-02-13T17:34:52-05:00&ctx_id=&ctx_enc=info:ofi/enc:UTF-8&rft.primo=dedupmrg32049651&rft.isbn=0754679489&rft.btitle=Manifestoes+and+transformations+in+the+early+modernist+city&rft.pub=Ashgate+Pub.+Company&rft.genre=book&rft.place=Farnham,+Surrey,+England,+;+Burlington,+Vt.&rft.aulast=Hermansen+Cordua&rft.aufirst=Christian&rft_val_fmt=info:ofi/fmt:kev:mtx:book&rfr_id=info:sid/primo.exlibrisgroup.com:primo-dedupmrg32049651",Book | Manifestoes and transformations in the early modernist city | Hermansen Cordua Christian 2010 |  | Publisher:Ashgate Pub Co ISBN:0754679489,0,0,5,0,5,5,0,100,0,0,0,0,0
"getit.library.nyu.edu/resolve?umlaut.referent_id=18829837&url_ver=Z39.88-2004&url_ctx_fmt=info:ofi/fmt:kev:mtx:ctx&ctx_ver=Z39.88-2004&ctx_tim=2022-02-14T19:24:10-05:00&ctx_id=&ctx_enc=info:ofi/enc:UTF-8&rft.au=J.+L.+Holzgrefe&rft.aucorp=Holzgrefe/Keohane&rft.aufirst=J.+L.&rft.auinitm=L&rft.aulast=Holzgrefe&rft.btitle=Humanitarian+intervention+:+ethical,+legal,+and+political+dilemmas&rft.date=2003&rft.eisbn=9786611113094&rft.eisbn_additional=0-511-33798-1&rft.genre=book&rft.isbn=0521821983&rft.isbn_additional=0-521-52928-X&rft.language=eng&rft.object_id=1000000000688967&rft.oclcnum=648328457&rft.place=Cambridge+;+New+York&rft.primo=dedupmrg129809891&rft.private_data=<nyu_aleph>003893486</nyu_aleph><grp_id>130683236</grp_id><oa></oa>&rft.pub=Cambridge+University+Press&rft.stitle=HUMANITARIAN+INTERVENTION&rft.title=Humanitarian+intervention+:+ethical,+legal,+and+political+dilemmas&rft.tpages=350&rft_val_fmt=info:ofi/fmt:kev:mtx:book&rfr_id=info:sid/primo.exlibrisgroup.com:primo-dedupmrg129809891",Book | Humanitarian intervention ethical legal and political dilemmas | J L Holzgrefe 2003 |  | Publisher:Cambridge University Press ISBN:0521821983,0,0,5,0,5,5,0,100,0,0,0,0,0
"getit.library.nyu.edu/resolve?umlaut.referent_id=18833043&url_ver=Z39.88-2004&url_ctx_fmt=info:ofi/fmt:kev:mtx:ctx&ctx_ver=Z39.88-2004&ctx_tim=2022-02-17T13:16:11-05:00&ctx_id=&ctx_enc=info:ofi/enc:UTF-8&rft.au=Hermansen+Cordua,+Christian&rft.aucorp=Hermansen+Cordua,+Christian,+Professor&rft.aufirst=Christian&rft.aulast=Hermansen+Cordua&rft.btitle=Manifestoes+and+transformations+in+the+early+modernist+city&rft.date=2010&rft.eisbn=1-317-10120-0&rft.eisbn_additional=978-1-317-10119-2&rft.genre=book&rft.isbn=0754679489&rft.isbn_additional=978-0-7546-7949-3&rft.language=eng&rft.lccn=2009040133&rft.object_id=2520000000007155&rft.oclcnum=647885929&rft.place=Farnham,+Surrey,+England,+;+Burlington,+Vt.&rft.primo=dedupmrg32049651&rft.pub=Ashgate+Pub.+Co.&rft.title=Manifestoes+and+transformations+in+the+early+modernist+city&rft.tpages=311&rft_val_fmt=info:ofi/fmt:kev:mtx:book&rfr_id=info:sid/primo.exlibrisgroup.com:primo-dedupmrg32049651",Book | Manifestoes and transformations in the early modernist city | Hermansen Cordua Christian 2010 |  | Publisher:Ashgate Pub Co ISBN:0754679489,0,0,5,0,5,5,0,100,0,0,0,0,0
"getit.library.nyu.edu/resolve?umlaut.referent_id=18840138&url_ver=Z39.88-2004&url_ctx_fmt=info:ofi/fmt:kev:mtx:ctx&ctx_ver=Z39.88-2004&ctx_tim=2022-02-20T14:30:36-05:00&ctx_id=&ctx_enc=info:ofi/enc:UTF-8&rft.btitle=Morality+Tales+:+Law+and+Gender+in+the+Ottoman+Court+of+Aintab.&rft.date=2003&rft.eisbn=1-282-75894-2&rft.eisbn_additional=978-1-59734-762-4&rft.eissn=9780520228900&rft.genre=book&rft.isbn=1597347620&rft.isbn_additional=978-0-520-22890-0&rft.language=eng&rft.lccn=2002152228&rft.object_id=1000000000005332&rft.oclcnum=475928359&rft.place=Berkeley,+CA&rft.primo=dedupmrg493373635&rft.private_data=<nyu_aleph>003188895</nyu_aleph><grp_id>553184132</grp_id><oa></oa><url></url>&rft.pub=University+of+California+Press&rft.stitle=MORALITY+TALES+:+LAW+&+GENDER+IN+THE+OTTOMAN+COURT+OF+AINTAB=&rft.title=Morality+Tales+:+Law+and+Gender+in+the+Ottoman+Court+of+Aintab.&rft.tpages=491&rft.au=Peirce,+Leslie&rft.aulast=Peirce&rft.aufirst=Leslie.&rft.auinitm=P&rft_val_fmt=info:ofi/fmt:kev:mtx:book&rfr_id=info:sid/primo.exlibrisgroup.com:primo-dedupmrg493373635",Book | Morality tales law and gender in the Ottoman court of Aintab | Peirce Leslie P 2003 |  | Publisher:University of California Press ISBN:1597347620,1,0,11,1,12,13,8,92,0,0,0,0,0
"getit.library.nyu.edu/resolve?umlaut.referent_id=18851537&url_ver=Z39.88-2004&url_ctx_fmt=info:ofi/fmt:kev:mtx:ctx&ctx_ver=Z39.88-2004&ctx_tim=2022-02-26T14:00:01-05:00&ctx_id=&ctx_enc=info:ofi/enc:UTF-8&rft.btitle=Theatre+for+change+:+education,+social+action+and+therapy&rft.date=2012&rft.eisbn=1-137-00374-X&rft.eissn=9781137003744&rft.genre=book&rft.isbn=113700374X&rft.language=eng&rft.lccn=2012023003&rft.object_id=3710000000479568&rft.oclcnum=915155241&rft.place=New+York&rft.primo=dedupmrg492431614&rft.private_data=<nyu_aleph>005986930</nyu_aleph><grp_id>553409491</grp_id><oa></oa><url></url>&rft.pub=Palgrave+Macmillan&rft.title=Theatre+for+change+:+education,+social+action+and+therapy&rft.tpages=352&rft.au=Landy,+Robert+J&rft.aulast=Landy&rft.aufirst=Robert+J.&rft.auinitm=J&rft_val_fmt=info:ofi/fmt:kev:mtx:book&rfr_id=info:sid/primo.exlibrisgroup.com:primo-dedupmrg492431614",Book | Theatre for change education social action and therapy | Landy Robert J 2012 |  | Publisher:Palgrave Macmillan ISBN:113700374X,0,0,2,0,2,2,0,100,0,0,0,0,0
"getit.library.nyu.edu/resolve?umlaut.referent_id=18852078&url_ver=Z39.88-2004&url_ctx_fmt=info:ofi/fmt:kev:mtx:ctx&ctx_ver=Z39.88-2004&ctx_tim=2022-02-27T17:47:20-05:00&ctx_id=&ctx_enc=info:ofi/enc:UTF-8&rft.au=Bohl,+Charles+C.&rft.aucorp=Bohl,+Charles&rft.aufirst=Charles&rft.auinitm=C&rft.aulast=Bohl&rft.btitle=Sitte,+Hegemann+and+the+metropolis+modern+civic+art+and+international+exchanges&rft.date=2008&rft.eisbn=1-135-23473-6&rft.eisbn_additional=9786612153570&rft.genre=book&rft.isbn=9780203866016&rft.isbn_additional=978-0-415-42407-3&rft.language=eng&rft.object_id=1000000000762230&rft.place=New+York&rft.primo=nyu_aleph003873477&rft.private_data=<nyu_aleph>003873477</nyu_aleph>&rft.pub=Routledge&rft.stitle=SITTE,+HEGEMANN+AND+THE+METROPOLIS&rft.title=Sitte,+Hegemann+and+the+metropolis+modern+civic+art+and+international+exchanges&rft.tpages=316&rft_val_fmt=info:ofi/fmt:kev:mtx:book&rfr_id=info:sid/primo.exlibrisgroup.com:primo-nyu_aleph003873477",Book | Sitte Hegemann and the metropolis modern civic art and international exchanges | Bohl Charles C 2008 |  | Publisher:Routledge ISBN:9780203866016,0,0,2,0,2,2,0,100,0,0,0,0,0
getit.library.nyu.edu/resolve?umlaut.referent_id=18852082&url_ver=Z39.88-2004&url_ctx_fmt=info:ofi/fmt:kev:mtx:ctx&ctx_ver=Z39.88-2004&ctx_tim=2022-02-27T01:34:37-05:00&ctx_id=&ctx_enc=info:ofi/enc:UTF-8&rft.au=Richard+T.+LeGates&rft.aufirst=Richard+T.&rft.aulast=LeGates&rft.btitle=The+city+reader&rft.date=2011&rft.eisbn=0-203-86926-5&rft.eisbn_additional=9786613045386&rft.genre=book&rft.isbn=9780415556644&rft.isbn_additional=978-0-415-55664-4&rft.language=eng&rft.lccn=2010027851&rft.object_id=2560000000061550&rft.oclcnum=712654434&rft.place=London+;+New+York&rft.primo=dedupmrg52787609&rft.pub=Routledge&rft.stitle=CITY+READER+:+ROUTLEDGE+URBAN+READER+SERIES&rft.title=The+city+reader&rft.tpages=624&rft_val_fmt=info:ofi/fmt:kev:mtx:book&rfr_id=info:sid/primo.exlibrisgroup.com:primo-dedupmrg52787609,Book | The city reader | Richard T LeGates 2011 |  | Publisher:Routledge ISBN:9780415556644,0,0,1,0,1,1,0,100,0,0,0,0,0
getit.library.nyu.edu/resolve?umlaut.referent_id=18852082&url_ver=Z39.88-2004&url_ctx_fmt=info:ofi/fmt:kev:mtx:ctx&ctx_ver=Z39.88-2004&ctx_tim=2022-02-27T19:02:47-05:00&ctx_id=&ctx_enc=info:ofi/enc:UTF-8&rft.au=Richard+T.+LeGates&rft.aufirst=Richard+T.&rft.aulast=LeGates&rft.btitle=The+city+reader&rft.date=2011&rft.eisbn=0-203-86926-5&rft.eisbn_additional=9786613045386&rft.genre=book&rft.isbn=9780415556644&rft.isbn_additional=978-0-415-55664-4&rft.language=eng&rft.lccn=2010027851&rft.object_id=2560000000061550&rft.oclcnum=712654434&rft.place=London+;+New+York&rft.primo=dedupmrg52787609&rft.pub=Routledge&rft.stitle=CITY+READER+:+ROUTLEDGE+URBAN+READER+SERIES&rft.title=The+city+reader&rft.tpages=624&rft_val_fmt=info:ofi/fmt:kev:mtx:book&rfr_id=info:sid/primo.exlibrisgroup.com:primo-dedupmrg52787609,Book | The city reader | Richard T LeGates 2011 |  | Publisher:Routledge ISBN:9780415556644,0,0,1,0,1,1,0,100,0,0,0,0,0
"getit.library.nyu.edu/resolve?umlaut.referent_id=18853333&url_ver=Z39.88-2004&url_ctx_fmt=info:ofi/fmt:kev:mtx:ctx&ctx_ver=Z39.88-2004&ctx_tim=2022-02-27T16:52:59-05:00&ctx_id=&ctx_enc=info:ofi/enc:UTF-8&rft.btitle=The+fundamentals+of+political+science+research&rft.eisbn=1-139-10425-X&rft.genre=book&rft.isbn=9781139104258&rft.language=eng&rft.object_id=2670000000361640&rft.place=Cambridge+;+New+York&rft.primo=nyu_aleph003784401&rft.private_data=<nyu_aleph>003784401</nyu_aleph><grp_id>65962761</grp_id><oa></oa>&rft.pub=Cambridge+University+Press&rft.title=The+fundamentals+of+political+science+research&rft.au=Kellstedt,+Paul+M.,+1968-&rft.aulast=Kellstedt&rft.aufirst=Paul+M.,&rft_val_fmt=info:ofi/fmt:kev:mtx:book&rfr_id=info:sid/primo.exlibrisgroup.com:primo-nyu_aleph003784401",Book | The fundamentals of political science research | Kellstedt Paul M 2013 |  | Publisher:Cambridge University Press ISBN:9781139104258,0,0,1,0,1,1,0,100,0,0,0,0,0
"getit.library.nyu.edu/resolve?umlaut.referent_id=18865318&url_ver=Z39.88-2004&url_ctx_fmt=info:ofi/fmt:kev:mtx:ctx&ctx_ver=Z39.88-2004&ctx_tim=2022-03-07T05:04:58-05:00&ctx_id=&ctx_enc=info:ofi/enc:UTF-8&rft.au=Hermansen+Cordua,+Christian&rft.aucorp=Hermansen+Cordua,+Christian,+Professor&rft.aufirst=Christian&rft.aulast=Hermansen+Cordua&rft.btitle=Manifestoes+and+transformations+in+the+early+modernist+city&rft.date=2010&rft.eisbn=1-317-10120-0&rft.eisbn_additional=978-1-317-10119-2&rft.genre=book&rft.isbn=0754679489&rft.isbn_additional=978-0-7546-7949-3&rft.language=eng&rft.lccn=2009040133&rft.object_id=2520000000007155&rft.oclcnum=647885929&rft.place=Farnham,+Surrey,+England,+;+Burlington,+Vt.&rft.primo=dedupmrg32049651&rft.pub=Ashgate+Pub.+Co.&rft.title=Manifestoes+and+transformations+in+the+early+modernist+city&rft.tpages=311&rft_val_fmt=info:ofi/fmt:kev:mtx:book&rfr_id=info:sid/primo.exlibrisgroup.com:primo-dedupmrg32049651",Book | Manifestoes and transformations in the early modernist city | Hermansen Cordua Christian 2010 |  | Publisher:Ashgate Pub Co ISBN:0754679489,0,0,5,0,5,5,0,100,0,0,0,0,0
getit.library.nyu.edu/resolve?umlaut.referent_id=18866754&url_ver=Z39.88-2004&url_ctx_fmt=info:ofi/fmt:kev:mtx:ctx&ctx_ver=Z39.88-2004&ctx_tim=2022-03-08T15:39:02-05:00&ctx_id=&ctx_enc=info:ofi/enc:UTF-8&rft.au=Richard+T.+LeGates&rft.aufirst=Richard+T.&rft.aulast=LeGates&rft.btitle=The+city+reader&rft.date=2011&rft.eisbn=0-203-86926-5&rft.eisbn_additional=9786613045386&rft.genre=book&rft.isbn=9780415556644&rft.isbn_additional=978-0-415-55664-4&rft.language=eng&rft.lccn=2010027851&rft.object_id=2560000000061550&rft.oclcnum=712654434&rft.place=London+;+New+York&rft.primo=dedupmrg52787609&rft.pub=Routledge&rft.stitle=CITY+READER+:+ROUTLEDGE+URBAN+READER+SERIES&rft.title=The+city+reader&rft.tpages=624&rft_val_fmt=info:ofi/fmt:kev:mtx:book&rfr_id=info:sid/primo.exlibrisgroup.com:primo-dedupmrg52787609,Book | The city reader | Richard T LeGates 2011 |  | Publisher:Routledge ISBN:9780415556644,0,0,1,0,1,1,0,100,0,0,0,0,0
"getit.library.nyu.edu/resolve?umlaut.referent_id=18867921&url_ver=Z39.88-2004&url_ctx_fmt=info:ofi/fmt:kev:mtx:ctx&ctx_ver=Z39.88-2004&ctx_tim=2022-03-07T09:28:06-05:00&ctx_id=&ctx_enc=info:ofi/enc:UTF-8&rft.btitle=Handbook+of+development+economics&rft.date=1988&rft.genre=book&rft.isbn=0444703373&rft.language=eng&rft.lccn=87034960&rft.object_id=2630000000000100&rft.place=Amsterdam+;+New+York+:+New+York,+N.Y.,+U.S.A.&rft.primo=dedupmrg40069516&rft.private_data=<wccselsevier>ocn551342085</wccselsevier><grp_id>112151153</grp_id><oa></oa>&rft.pub=North-Holland+;+Sole+distributors+for+the+U.S.A.+and+Canada,+Elsevier+Science+Pub.+Co.&rft.stitle=HANDBOOK+OF+DEVELOPMENT+ECONOMICS&rft.title=Handbook+of+development+economics&rft.tpages=882&rft.au=Hollis+Burnley+Chenery&rft.aulast=Chenery&rft.aufirst=Hollis+Burnley&rft.auinitm=B&rft_val_fmt=info:ofi/fmt:kev:mtx:book&rfr_id=info:sid/primo.exlibrisgroup.com:primo-dedupmrg40069516",Book | Handbook of development economics | Hollis Burnley Chenery 1988 |  | Publisher:North-Holland Sole distributors for the U.S.A and Canada Elsevier Science Pub Co ISBN:0444703373,0,0,1,0,1,1,0,100,0,0,0,0,0
"getit.library.nyu.edu/resolve?umlaut.referent_id=18872530&url_ver=Z39.88-2004&url_ctx_fmt=info:ofi/fmt:kev:mtx:ctx&ctx_ver=Z39.88-2004&ctx_tim=2022-03-09T08:51:23-05:00&ctx_id=&ctx_enc=info:ofi/enc:UTF-8&rft.au=Boyar,+Ebru&rft.aufirst=Ebru.&rft.aulast=Boyar&rft.btitle=A+Social+History+of+Ottoman+Istanbul.&rft.date=2010&rft.eisbn=0-511-74892-2&rft.eisbn_additional=9786612651892&rft.eissn=9780521199551&rft.genre=book&rft.isbn=9780511744204&rft.isbn_additional=978-0-521-13623-5&rft.language=eng&rft.object_id=2560000000010115&rft.oclcnum=638859607&rft.place=Leiden&rft.primo=nyu_aleph003896109&rft.private_data=<nyu_aleph>003896109</nyu_aleph><grp_id>537333348</grp_id><oa></oa><url></url>&rft.pub=Cambridge+University+Press&rft.title=A+Social+History+of+Ottoman+Istanbul.&rft_val_fmt=info:ofi/fmt:kev:mtx:book&rfr_id=info:sid/primo.exlibrisgroup.com:primo-nyu_aleph003896109",Book | A Social History of Ottoman Istanbul. | Boyar Ebru 2010 |  | Publisher:Cambridge University Press ISBN:9780511744204,0,0,1,0,1,1,0,100,0,0,0,0,0
getit.library.nyu.edu/resolve?umlaut.referent_id=18875016&url_ver=Z39.88-2004&url_ctx_fmt=info:ofi/fmt:kev:mtx:ctx&ctx_ver=Z39.88-2004&ctx_tim=2022-03-10T11:16:21-05:00&ctx_id=&ctx_enc=info:ofi/enc:UTF-8&rft.jtitle=Journal+for+Islamic+Studies&rft_val_fmt=info:ofi/fmt:kev:mtx:journal&rfr_id=info:sid/umlaut.code4lib.org:opensearch,Journal | Journal for Islamic studies |  | ISSN:0257-7062 | undefined,3,0,1,3,4,7,43,57,0,0,0,0,0
"getit.library.nyu.edu/resolve?umlaut.referent_id=18876094&url_ver=Z39.88-2004&url_ctx_fmt=info:ofi/fmt:kev:mtx:ctx&ctx_ver=Z39.88-2004&ctx_tim=2022-03-10T20:18:54-05:00&ctx_id=&ctx_enc=info:ofi/enc:UTF-8&rft.primo=dedupmrg32049651&rft.isbn=0754679489&rft.btitle=Manifestoes+and+transformations+in+the+early+modernist+city&rft.pub=Ashgate+Pub.+Company&rft.genre=book&rft.place=Farnham,+Surrey,+England,+;+Burlington,+Vt.&rft.aulast=Hermansen+Cordua&rft.aufirst=Christian&rft_val_fmt=info:ofi/fmt:kev:mtx:book&rfr_id=info:sid/primo.exlibrisgroup.com:primo-dedupmrg32049651",Book | Manifestoes and transformations in the early modernist city | Hermansen Cordua Christian 2010 |  | Publisher:Ashgate Pub Co ISBN:0754679489,0,0,5,0,5,5,0,100,0,0,0,0,0
"getit.library.nyu.edu/resolve?umlaut.referent_id=18876569&url_ver=Z39.88-2004&url_ctx_fmt=info:ofi/fmt:kev:mtx:ctx&ctx_ver=Z39.88-2004&ctx_tim=2022-03-11T09:56:17-05:00&ctx_id=&ctx_enc=info:ofi/enc:UTF-8&rft.au=Bohl,+Charles+C.&rft.aucorp=Bohl,+Charles&rft.aufirst=Charles&rft.auinitm=C&rft.aulast=Bohl&rft.btitle=Sitte,+Hegemann+and+the+metropolis+modern+civic+art+and+international+exchanges&rft.date=2008&rft.eisbn=1-135-23473-6&rft.eisbn_additional=9786612153570&rft.genre=book&rft.isbn=9780203866016&rft.isbn_additional=978-0-415-42407-3&rft.language=eng&rft.object_id=1000000000762230&rft.place=New+York&rft.primo=nyu_aleph003873477&rft.private_data=<nyu_aleph>003873477</nyu_aleph>&rft.pub=Routledge&rft.stitle=SITTE,+HEGEMANN+AND+THE+METROPOLIS&rft.title=Sitte,+Hegemann+and+the+metropolis+modern+civic+art+and+international+exchanges&rft.tpages=316&rft_val_fmt=info:ofi/fmt:kev:mtx:book&rfr_id=info:sid/primo.exlibrisgroup.com:primo-nyu_aleph003873477",Book | Sitte Hegemann and the metropolis modern civic art and international exchanges | Bohl Charles C 2008 |  | Publisher:Routledge ISBN:9780203866016,0,0,2,0,2,2,0,100,0,0,0,0,0
"getit.library.nyu.edu/resolve?umlaut.referent_id=18881646&url_ver=Z39.88-2004&url_ctx_fmt=info:ofi/fmt:kev:mtx:ctx&ctx_ver=Z39.88-2004&ctx_tim=2022-03-24T09:38:04-04:00&ctx_id=&ctx_enc=info:ofi/enc:UTF-8&rft.au=Cicero,+Marcus+Tullius&rft.aucorp=Powell,+Jonathan&rft.aufirst=Marcus+Tullius,&rft.auinitm=T&rft.aulast=Cicero&rft.btitle=The+republic+:+and,+the+laws&rft.date=1998&rft.eisbn=0-19-183841-1&rft.eisbn_additional=978-0-19-159356-7&rft.eissn=0192832360&rft.genre=book&rft.isbn=9780191593567&rft.isbn_additional=978-0-19-954011-2&rft.language=eng&rft.lccn=97023394&rft.object_id=111004366524650&rft.oclcnum=44963338&rft.place=Oxford&rft.primo=dedupmrg492058377&rft.private_data=<nyu_aleph>004774783</nyu_aleph><grp_id>534855026</grp_id><oa></oa><url></url>&rft.pub=Oxford+University+Press&rft.stitle=REPUBLIC&rft.title=The+republic+:+and,+the+laws&rft.tpages=242&rft_val_fmt=info:ofi/fmt:kev:mtx:book&rfr_id=info:sid/primo.exlibrisgroup.com:primo-dedupmrg492058377",Book | The republic and the laws | Cicero Marcus Tullius 1998 |  | Publisher:Oxford University Press ISBN:9780191593567,0,0,2,0,2,2,0,100,0,0,0,0,0
"getit.library.nyu.edu/resolve?umlaut.referent_id=18881646&url_ver=Z39.88-2004&url_ctx_fmt=info:ofi/fmt:kev:mtx:ctx&ctx_ver=Z39.88-2004&ctx_tim=2022-03-24T22:14:43-04:00&ctx_id=&ctx_enc=info:ofi/enc:UTF-8&rft.au=Cicero,+Marcus+Tullius&rft.aucorp=Powell,+Jonathan&rft.aufirst=Marcus+Tullius,&rft.auinitm=T&rft.aulast=Cicero&rft.btitle=The+republic+:+and,+the+laws&rft.date=1998&rft.eisbn=0-19-183841-1&rft.eisbn_additional=978-0-19-159356-7&rft.eissn=0192832360&rft.genre=book&rft.isbn=9780191593567&rft.isbn_additional=978-0-19-954011-2&rft.language=eng&rft.lccn=97023394&rft.object_id=111004366524650&rft.oclcnum=44963338&rft.place=Oxford&rft.primo=dedupmrg492058377&rft.private_data=<nyu_aleph>004774783</nyu_aleph><grp_id>534855026</grp_id><oa></oa><url></url>&rft.pub=Oxford+University+Press&rft.stitle=REPUBLIC&rft.title=The+republic+:+and,+the+laws&rft.tpages=242&rft_val_fmt=info:ofi/fmt:kev:mtx:book&rfr_id=info:sid/primo.exlibrisgroup.com:primo-dedupmrg492058377",Book | The republic and the laws | Cicero Marcus Tullius 1998 |  | Publisher:Oxford University Press ISBN:9780191593567,0,0,2,0,2,2,0,100,0,0,0,0,0
"getit.library.nyu.edu/resolve?umlaut.referent_id=18881646&url_ver=Z39.88-2004&url_ctx_fmt=info:ofi/fmt:kev:mtx:ctx&ctx_ver=Z39.88-2004&ctx_tim=2022-03-25T01:52:35-04:00&ctx_id=&ctx_enc=info:ofi/enc:UTF-8&rft.au=Cicero,+Marcus+Tullius&rft.aucorp=Powell,+Jonathan&rft.aufirst=Marcus+Tullius,&rft.auinitm=T&rft.aulast=Cicero&rft.btitle=The+republic+:+and,+the+laws&rft.date=1998&rft.eisbn=0-19-183841-1&rft.eisbn_additional=978-0-19-159356-7&rft.eissn=0192832360&rft.genre=book&rft.isbn=9780191593567&rft.isbn_additional=978-0-19-954011-2&rft.language=eng&rft.lccn=97023394&rft.object_id=111004366524650&rft.oclcnum=44963338&rft.place=Oxford&rft.primo=dedupmrg492058377&rft.private_data=<nyu_aleph>004774783</nyu_aleph><grp_id>534855026</grp_id><oa></oa><url></url>&rft.pub=Oxford+University+Press&rft.stitle=REPUBLIC&rft.title=The+republic+:+and,+the+laws&rft.tpages=242&rft_val_fmt=info:ofi/fmt:kev:mtx:book&rfr_id=info:sid/primo.exlibrisgroup.com:primo-dedupmrg492058377",Book | The republic and the laws | Cicero Marcus Tullius 1998 |  | Publisher:Oxford University Press ISBN:9780191593567,0,0,2,0,2,2,0,100,0,0,0,0,0
"getit.library.nyu.edu/resolve?umlaut.referent_id=18882660&url_ver=Z39.88-2004&url_ctx_fmt=info:ofi/fmt:kev:mtx:ctx&ctx_ver=Z39.88-2004&ctx_tim=2022-03-16T17:40:28-04:00&ctx_id=&ctx_enc=info:ofi/enc:UTF-8&rft.au=Jacobsen,+Thorkild&rft.aucorp=THORKILD+JACOBSEN&rft.aufirst=Thorkild,&rft.aulast=Jacobsen&rft.btitle=The+Harps+that+once--+:+Sumerian+poetry+in+translation&rft.date=1987&rft.eisbn=0-300-16187-5&rft.eissn=0300039069&rft.genre=book&rft.isbn=9780300161878&rft.language=eng&rft.lccn=87010559&rft.object_id=3360000000476265&rft.oclcnum=jst861792476&rft.place=New+Haven+;+London&rft.primo=dedupmrg374027928&rft.private_data=<nyu_aleph>005785687</nyu_aleph><grp_id>433402477</grp_id><oa></oa><url></url>&rft.pub=Yale+University+Press&rft.title=The+Harps+that+once--+:+Sumerian+poetry+in+translation&rft_val_fmt=info:ofi/fmt:kev:mtx:book&rfr_id=info:sid/primo.exlibrisgroup.com:primo-dedupmrg374027928",Book | The Harps that once Sumerian poetry in translation | Jacobsen Thorkild 1987 |  | Publisher:Yale University Press ISBN:9780300161878,0,0,2,0,2,2,0,100,0,0,0,0,0
getit.library.nyu.edu/resolve?umlaut.referent_id=18884317&url_ver=Z39.88-2004&url_ctx_fmt=info:ofi/fmt:kev:mtx:ctx&ctx_ver=Z39.88-2004&ctx_tim=2022-03-17T12:47:52-04:00&ctx_id=&ctx_enc=info:ofi/enc:UTF-8&rft.jtitle=Journal+for+Islamic+Studies&rft_val_fmt=info:ofi/fmt:kev:mtx:journal&rfr_id=info:sid/umlaut.code4lib.org:opensearch,Journal | Journal for Islamic studies |  | ISSN:0257-7062 | undefined,3,0,1,3,4,7,43,57,0,0,0,0,0
getit.library.nyu.edu/resolve?umlaut.referent_id=18897926&url_ver=Z39.88-2004&url_ctx_fmt=info:ofi/fmt:kev:mtx:ctx&ctx_ver=Z39.88-2004&ctx_tim=2022-03-30T13:33:03-04:00&ctx_id=&ctx_enc=info:ofi/enc:UTF-8&rft.au=Richard+T.+LeGates&rft.aufirst=Richard+T.&rft.aulast=LeGates&rft.btitle=The+city+reader&rft.date=2011&rft.eisbn=0-203-86926-5&rft.eisbn_additional=9786613045386&rft.genre=book&rft.isbn=9780415556644&rft.isbn_additional=978-0-415-55664-4&rft.language=eng&rft.lccn=2010027851&rft.object_id=2560000000061550&rft.oclcnum=712654434&rft.place=London+;+New+York&rft.primo=dedupmrg52787609&rft.pub=Routledge&rft.stitle=CITY+READER+:+ROUTLEDGE+URBAN+READER+SERIES&rft.title=The+city+reader&rft.tpages=624&rft_val_fmt=info:ofi/fmt:kev:mtx:book&rfr_id=info:sid/primo.exlibrisgroup.com:primo-dedupmrg52787609,Book | The city reader | Richard T LeGates 2011 |  | Publisher:Routledge ISBN:9780415556644,0,0,1,0,1,1,0,100,0,0,0,0,0
"getit.library.nyu.edu/resolve?umlaut.referent_id=18902099&url_ver=Z39.88-2004&url_ctx_fmt=info:ofi/fmt:kev:mtx:ctx&ctx_ver=Z39.88-2004&ctx_tim=2022-03-31T03:26:59-04:00&ctx_id=&ctx_enc=info:ofi/enc:UTF-8&rft.au=Fuhrmann,+Geri+S.+W&rft.aucorp=Robert+A.+Zibbell&rft.aufirst=Geri+S.+W.&rft.aulast=Fuhrmann&rft.btitle=Evaluation+for+child+custody&rft.date=2011&rft.eisbn=0-19-026157-9&rft.eisbn_additional=9786613348760&rft.eissn=9780195329513&rft.genre=book&rft.isbn=9780190261573&rft.language=eng&rft.object_id=2550000000064980&rft.oclcnum=767731308&rft.place=New+York+;+Oxford&rft.primo=nyu_aleph005391667&rft.private_data=<nyu_aleph>005391667</nyu_aleph><grp_id>538498817</grp_id><oa></oa><url></url>&rft.pub=Oxford+University+Press&rft.title=Evaluation+for+child+custody&rft.tpages=288&rft_val_fmt=info:ofi/fmt:kev:mtx:book&rfr_id=info:sid/primo.exlibrisgroup.com:primo-nyu_aleph005391667",Book | Evaluation for child custody | Fuhrmann Geri S W 2011 |  | Publisher:Oxford University Press ISBN:9780190261573,0,0,1,0,1,1,0,100,0,0,0,0,0
"getit.library.nyu.edu/resolve?umlaut.referent_id=18902583&url_ver=Z39.88-2004&url_ctx_fmt=info:ofi/fmt:kev:mtx:ctx&ctx_ver=Z39.88-2004&ctx_tim=2022-03-30T08:51:40-04:00&ctx_id=&ctx_enc=info:ofi/enc:UTF-8&rft.au=Zarinebaf,+F.+(Fariba)&rft.aucorp=Zarinebaf,+F&rft.aufirst=F.&rft.auinitm=F&rft.aulast=Zarinebaf&rft.btitle=Crime+and+punishment+in+Istanbul+:+1700/1800&rft.date=2011&rft.eisbn=0-520-94756-8&rft.eisbn_additional=9786613277305&rft.eissn=9780520262201&rft.genre=book&rft.isbn=9780520947566&rft.language=eng&rft.lccn=2010020820&rft.object_id=2670000000059715&rft.oclcnum=701053852&rft.place=Berkeley&rft.primo=dedupmrg491479160&rft.private_data=<nyu_aleph>003570251</nyu_aleph><grp_id>553296020</grp_id><oa></oa><url></url>&rft.pub=University+of+California+Press&rft.stitle=CRIME+AND+PUNISHMENT+IN+ISTANBUL&rft.title=Crime+and+punishment+in+Istanbul+:+1700/1800&rft.tpages=304&rft_val_fmt=info:ofi/fmt:kev:mtx:book&rfr_id=info:sid/primo.exlibrisgroup.com:primo-dedupmrg491479160",Book | Crime and punishment in Istanbul 1700/1800 | Zarinebaf F Fariba 2011 |  | Publisher:University of California Press ISBN:9780520947566,0,0,6,0,6,6,0,100,0,0,0,0,0
"getit.library.nyu.edu/resolve?umlaut.referent_id=18902951&url_ver=Z39.88-2004&url_ctx_fmt=info:ofi/fmt:kev:mtx:ctx&ctx_ver=Z39.88-2004&ctx_tim=2022-03-28T12:56:35-04:00&ctx_id=&ctx_enc=info:ofi/enc:UTF-8&rft.btitle=The+tempest&rft.eissn=9781408133477&rft.genre=book&rft.primo=nyu_aleph005885513&rft.private_data=<nyu_aleph>005885513</nyu_aleph><grp_id>21676334</grp_id><oa></oa><url></url>&rft.title=The+tempest&rft.au=Shakespeare,+William,+1564-1616,+author&rft.aulast=Shakespeare&rft.aufirst=William,&rft_val_fmt=info:ofi/fmt:kev:mtx:book&rfr_id=info:sid/primo.exlibrisgroup.com:primo-nyu_aleph005885513",Book | The Tempest | Shakespeare William |  | Publisher:Bloomsbury Publishing,0,0,2,0,2,2,0,100,0,0,0,0,0
"getit.library.nyu.edu/resolve?umlaut.referent_id=18907298&url_ver=Z39.88-2004&url_ctx_fmt=info:ofi/fmt:kev:mtx:ctx&ctx_ver=Z39.88-2004&ctx_tim=2022-03-30T12:30:06-04:00&ctx_id=&ctx_enc=info:ofi/enc:UTF-8&rft.au=Shakespeare,+William,+1564-1616,+author&rft.aufirst=William,&rft.aulast=Shakespeare&rft.btitle=The+tempest&rft.eissn=9781408133477&rft.genre=book&rft.primo=nyu_aleph005885513&rft.private_data=<nyu_aleph>005885513</nyu_aleph><grp_id>21676334</grp_id><oa></oa><url></url>&rft.title=The+tempest&rft_val_fmt=info:ofi/fmt:kev:mtx:book&rfr_id=info:sid/primo.exlibrisgroup.com:primo-nyu_aleph005885513",Book | The Tempest | Shakespeare William |  | Publisher:Bloomsbury Publishing,0,0,2,0,2,2,0,100,0,0,0,0,0
"getit.library.nyu.edu/resolve?umlaut.referent_id=18910318&url_ver=Z39.88-2004&url_ctx_fmt=info:ofi/fmt:kev:mtx:ctx&ctx_ver=Z39.88-2004&ctx_tim=2022-03-31T22:55:46-04:00&ctx_id=&ctx_enc=info:ofi/enc:UTF-8&rft.au=Bodin,+Jean&rft.aucorp=Bodin,+Jean;+Franklin,+Julian+H.&rft.aufirst=Jean,&rft.aulast=Bodin&rft.btitle=On+sovereignty+:+four+chapters+from+the+six+books+of+the+commonwealth&rft.date=1992&rft.eisbn=0-511-80281-1&rft.eisbn_additional=978-0-511-80281-2&rft.eissn=0521342066+9780521342063+0521349923+9780521349925&rft.genre=book&rft.isbn=0511802811&rft.isbn_additional=978-0-521-34992-5&rft.language=eng&rft.lccn=91019029&rft.object_id=2560000000091611&rft.oclcnum=818234291&rft.place=Cambridge+[England]+;+New+York&rft.primo=dedupmrg490082093&rft.private_data=<nyu_aleph>003984836</nyu_aleph><grp_id>553189221</grp_id><oa></oa><url></url>&rft.pub=Cambridge+University+Press&rft.title=On+sovereignty+:+four+chapters+from+the+six+books+of+the+commonwealth&rft_val_fmt=info:ofi/fmt:kev:mtx:book&rfr_id=info:sid/primo.exlibrisgroup.com:primo-dedupmrg490082093",Book | On sovereignty four chapters from the Six books of the commonwealth | Bodin Jean 1992 |  | Publisher:Cambridge University Press ISBN:0511802811,0,0,1,0,1,1,0,100,0,0,0,0,0
"getit.library.nyu.edu/resolve?umlaut.referent_id=18914023&url_ver=Z39.88-2004&url_ctx_fmt=info:ofi/fmt:kev:mtx:ctx&ctx_ver=Z39.88-2004&ctx_tim=2022-04-06T11:42:44-04:00&ctx_id=&ctx_enc=info:ofi/enc:UTF-8&rft.au=Toledano,+Ehud+R.&rft.aucorp=Project+Muse&rft.aufirst=Ehud+R.,&rft.auinitm=R&rft.aulast=Toledano&rft.btitle=Slavery+and+abolition+in+the+Ottoman+Middle+East&rft.date=1998&rft.eisbn=0-295-80242-1&rft.eisbn_additional=978-0-295-98065-2&rft.eissn=9780295976426&rft.genre=book&rft.isbn=029597642X&rft.language=eng&rft.lccn=97009571&rft.object_id=1000000000442162&rft.oclcnum=884588121&rft.place=Seattle&rft.primo=dedupmrg493004690&rft.private_data=<nyu_aleph>005816038</nyu_aleph><grp_id>553011009</grp_id><oa></oa><url></url>&rft.pub=University+of+Washington+Press&rft.title=Slavery+and+abolition+in+the+Ottoman+Middle+East&rft.tpages=185&rft_val_fmt=info:ofi/fmt:kev:mtx:book&rfr_id=info:sid/primo.exlibrisgroup.com:primo-dedupmrg493004690",Book | Slavery and abolition in the Ottoman Middle East | Toledano Ehud R 1998 |  | Publisher:University of Washington Press ISBN:029597642X,0,0,6,0,6,6,0,100,0,0,0,0,0
getit.library.nyu.edu/resolve?umlaut.referent_id=18914121&url_ver=Z39.88-2004&url_ctx_fmt=info:ofi/fmt:kev:mtx:ctx&ctx_ver=Z39.88-2004&ctx_tim=2022-04-03T16:47:27-04:00&ctx_id=&ctx_enc=info:ofi/enc:UTF-8&rft.au=Richard+T.+LeGates&rft.aufirst=Richard+T.&rft.aulast=LeGates&rft.btitle=The+city+reader&rft.date=2011&rft.eisbn=0-203-86926-5&rft.eisbn_additional=9786613045386&rft.genre=book&rft.isbn=9780415556644&rft.isbn_additional=978-0-415-55664-4&rft.language=eng&rft.lccn=2010027851&rft.object_id=2560000000061550&rft.oclcnum=712654434&rft.place=London+;+New+York&rft.primo=dedupmrg52787609&rft.pub=Routledge&rft.stitle=CITY+READER+:+ROUTLEDGE+URBAN+READER+SERIES&rft.title=The+city+reader&rft.tpages=624&rft_val_fmt=info:ofi/fmt:kev:mtx:book&rfr_id=info:sid/primo.exlibrisgroup.com:primo-dedupmrg52787609,Book | The city reader | Richard T LeGates 2011 |  | Publisher:Routledge ISBN:9780415556644,0,0,1,0,1,1,0,100,0,0,0,0,0
getit.library.nyu.edu/resolve?umlaut.referent_id=18914121&url_ver=Z39.88-2004&url_ctx_fmt=info:ofi/fmt:kev:mtx:ctx&ctx_ver=Z39.88-2004&ctx_tim=2022-04-06T13:10:48-04:00&ctx_id=&ctx_enc=info:ofi/enc:UTF-8&rft.au=Richard+T.+LeGates&rft.aufirst=Richard+T.&rft.aulast=LeGates&rft.btitle=The+city+reader&rft.date=2011&rft.eisbn=0-203-86926-5&rft.eisbn_additional=9786613045386&rft.genre=book&rft.isbn=9780415556644&rft.isbn_additional=978-0-415-55664-4&rft.language=eng&rft.lccn=2010027851&rft.object_id=2560000000061550&rft.oclcnum=712654434&rft.place=London+;+New+York&rft.primo=dedupmrg52787609&rft.pub=Routledge&rft.stitle=CITY+READER+:+ROUTLEDGE+URBAN+READER+SERIES&rft.title=The+city+reader&rft.tpages=624&rft_val_fmt=info:ofi/fmt:kev:mtx:book&rfr_id=info:sid/primo.exlibrisgroup.com:primo-dedupmrg52787609,Book | The city reader | Richard T LeGates 2011 |  | Publisher:Routledge ISBN:9780415556644,0,0,1,0,1,1,0,100,0,0,0,0,0
"getit.library.nyu.edu/resolve?umlaut.referent_id=18931935&url_ver=Z39.88-2004&url_ctx_fmt=info:ofi/fmt:kev:mtx:ctx&ctx_ver=Z39.88-2004&ctx_tim=2022-04-14T21:17:23-04:00&ctx_id=&ctx_enc=info:ofi/enc:UTF-8&rft.au=Bodin,+Jean&rft.aucorp=Bodin,+Jean;+Franklin,+Julian+H.&rft.aufirst=Jean,&rft.aulast=Bodin&rft.btitle=On+sovereignty+:+four+chapters+from+the+six+books+of+the+commonwealth&rft.date=1992&rft.eisbn=0-511-80281-1&rft.eisbn_additional=978-0-511-80281-2&rft.eissn=0521342066+9780521342063+0521349923+9780521349925&rft.genre=book&rft.isbn=0511802811&rft.isbn_additional=978-0-521-34992-5&rft.language=eng&rft.lccn=91019029&rft.object_id=2560000000091611&rft.oclcnum=818234291&rft.place=Cambridge+[England]+;+New+York&rft.primo=dedupmrg490082093&rft.private_data=<nyu_aleph>003984836</nyu_aleph><grp_id>553189221</grp_id><oa></oa><url></url>&rft.pub=Cambridge+University+Press&rft.title=On+sovereignty+:+four+chapters+from+the+six+books+of+the+commonwealth&rft_val_fmt=info:ofi/fmt:kev:mtx:book&rfr_id=info:sid/primo.exlibrisgroup.com:primo-dedupmrg490082093",Book | On sovereignty four chapters from the Six books of the commonwealth | Bodin Jean 1992 |  | Publisher:Cambridge University Press ISBN:0511802811,0,0,1,0,1,1,0,100,0,0,0,0,0
"getit.library.nyu.edu/resolve?umlaut.referent_id=18931935&url_ver=Z39.88-2004&url_ctx_fmt=info:ofi/fmt:kev:mtx:ctx&ctx_ver=Z39.88-2004&ctx_tim=2022-04-15T06:06:44-04:00&ctx_id=&ctx_enc=info:ofi/enc:UTF-8&rft.au=Bodin,+Jean&rft.aucorp=Bodin,+Jean;+Franklin,+Julian+H.&rft.aufirst=Jean,&rft.aulast=Bodin&rft.btitle=On+sovereignty+:+four+chapters+from+the+six+books+of+the+commonwealth&rft.date=1992&rft.eisbn=0-511-80281-1&rft.eisbn_additional=978-0-511-80281-2&rft.eissn=0521342066+9780521342063+0521349923+9780521349925&rft.genre=book&rft.isbn=0511802811&rft.isbn_additional=978-0-521-34992-5&rft.language=eng&rft.lccn=91019029&rft.object_id=2560000000091611&rft.oclcnum=818234291&rft.place=Cambridge+[England]+;+New+York&rft.primo=dedupmrg490082093&rft.private_data=<nyu_aleph>003984836</nyu_aleph><grp_id>553189221</grp_id><oa></oa><url></url>&rft.pub=Cambridge+University+Press&rft.title=On+sovereignty+:+four+chapters+from+the+six+books+of+the+commonwealth&rft_val_fmt=info:ofi/fmt:kev:mtx:book&rfr_id=info:sid/primo.exlibrisgroup.com:primo-dedupmrg490082093",Book | On sovereignty four chapters from the Six books of the commonwealth | Bodin Jean 1992 |  | Publisher:Cambridge University Press ISBN:0511802811,0,0,1,0,1,1,0,100,0,0,0,0,0
"getit.library.nyu.edu/resolve?umlaut.referent_id=18931940&url_ver=Z39.88-2004&url_ctx_fmt=info:ofi/fmt:kev:mtx:ctx&ctx_ver=Z39.88-2004&ctx_tim=2022-04-11T20:47:49-04:00&ctx_id=&ctx_enc=info:ofi/enc:UTF-8&rft.btitle=The+republic+:+and,+the+laws&rft.date=1998&rft.eisbn=0-19-183841-1&rft.eisbn_additional=978-0-19-159356-7&rft.eissn=0192832360&rft.genre=book&rft.isbn=9780191593567&rft.isbn_additional=978-0-19-954011-2&rft.language=eng&rft.lccn=97023394&rft.object_id=111004366524650&rft.oclcnum=44963338&rft.place=Oxford&rft.primo=dedupmrg492058377&rft.private_data=<nyu_aleph>004774783</nyu_aleph><grp_id>534855026</grp_id><oa></oa><url></url>&rft.pub=Oxford+University+Press&rft.stitle=REPUBLIC&rft.title=The+republic+:+and,+the+laws&rft.au=Cicero,+Marcus+Tullius&rft.aulast=Cicero&rft.aufirst=Marcus+Tullius.&rft.auinitm=T&rft_val_fmt=info:ofi/fmt:kev:mtx:book&rfr_id=info:sid/primo.exlibrisgroup.com:primo-dedupmrg492058377",Book | The republic and the laws | Cicero Marcus Tullius 1998 |  | Publisher:Oxford University Press ISBN:9780191593567,0,0,2,0,2,2,0,100,0,0,0,0,0
"getit.library.nyu.edu/resolve?umlaut.referent_id=18931940&url_ver=Z39.88-2004&url_ctx_fmt=info:ofi/fmt:kev:mtx:ctx&ctx_ver=Z39.88-2004&ctx_tim=2022-04-15T23:00:25-04:00&ctx_id=&ctx_enc=info:ofi/enc:UTF-8&rft.au=Cicero,+Marcus+Tullius&rft.aucorp=Powell,+Jonathan&rft.aufirst=Marcus+Tullius,&rft.auinitm=T&rft.aulast=Cicero&rft.btitle=The+republic+:+and,+the+laws&rft.date=1998&rft.eisbn=0-19-183841-1&rft.eisbn_additional=978-0-19-159356-7&rft.eissn=0192832360&rft.genre=book&rft.isbn=9780191593567&rft.isbn_additional=978-0-19-954011-2&rft.language=eng&rft.lccn=97023394&rft.object_id=111004366524650&rft.oclcnum=44963338&rft.place=Oxford&rft.primo=dedupmrg492058377&rft.private_data=<nyu_aleph>004774783</nyu_aleph><grp_id>534855026</grp_id><oa></oa><url></url>&rft.pub=Oxford+University+Press&rft.stitle=REPUBLIC&rft.title=The+republic+:+and,+the+laws&rft.tpages=242&rft_val_fmt=info:ofi/fmt:kev:mtx:book&rfr_id=info:sid/primo.exlibrisgroup.com:primo-dedupmrg492058377",Book | The republic and the laws | Cicero Marcus Tullius 1998 |  | Publisher:Oxford University Press ISBN:9780191593567,0,0,2,0,2,2,0,100,0,0,0,0,0
"getit.library.nyu.edu/resolve?umlaut.referent_id=18932525&url_ver=Z39.88-2004&url_ctx_fmt=info:ofi/fmt:kev:mtx:ctx&ctx_ver=Z39.88-2004&ctx_tim=2022-04-14T23:52:03-04:00&ctx_id=&ctx_enc=info:ofi/enc:UTF-8&rft.au=Ge\u0301ron,+Aure\u0301lien,+author&rft.aufirst=Aure\u0301lien,&rft.aulast=Ge\u0301ron&rft.btitle=Hands-on+machine+learning+with+Scikit-Learn+and+TensorFlow+:+concepts,+tools,+and+techniques+to+build+intelligent+systems&rft.date=2017&rft.genre=book&rft.isbn=9781491962244&rft.oclcnum=978351632&rft.primo=nyu_aleph005835977&rft.private_data=<nyu_aleph>005835977</nyu_aleph><grp_id>486247309</grp_id><oa></oa><url></url>&rft.pub=\",Book | Hands-on machine learning with Scikit-Learn and TensorFlow concepts tools and techniques to build intelligent systems | Géron Aurélien 2017 |  | Publisher ISBN:9781491962244,0,0,1,0,1,1,0,100,0,0,0,0,0
getit.library.nyu.edu/resolve?umlaut.referent_id=18953194&url_ver=Z39.88-2004&url_ctx_fmt=info:ofi/fmt:kev:mtx:ctx&ctx_ver=Z39.88-2004&ctx_tim=2022-04-22T16:47:46-04:00&ctx_id=&ctx_enc=info:ofi/enc:UTF-8&rft.au=Richard+T.+LeGates&rft.aufirst=Richard+T.&rft.aulast=LeGates&rft.btitle=The+city+reader&rft.date=2011&rft.eisbn=0-203-86926-5&rft.eisbn_additional=9786613045386&rft.genre=book&rft.isbn=9780415556644&rft.isbn_additional=978-0-415-55664-4&rft.language=eng&rft.lccn=2010027851&rft.object_id=2560000000061550&rft.oclcnum=712654434&rft.place=London+;+New+York&rft.primo=dedupmrg52787609&rft.pub=Routledge&rft.stitle=CITY+READER+:+ROUTLEDGE+URBAN+READER+SERIES&rft.title=The+city+reader&rft.tpages=624&rft_val_fmt=info:ofi/fmt:kev:mtx:book&rfr_id=info:sid/primo.exlibrisgroup.com:primo-dedupmrg52787609,Book | The city reader | Richard T LeGates 2011 |  | Publisher:Routledge ISBN:9780415556644,0,0,1,0,1,1,0,100,0,0,0,0,0
getit.library.nyu.edu/resolve?umlaut.referent_id=18980804&url_ver=Z39.88-2004&url_ctx_fmt=info:ofi/fmt:kev:mtx:ctx&ctx_ver=Z39.88-2004&ctx_tim=2022-05-09T11:46:11-04:00&ctx_id=&ctx_enc=info:ofi/enc:UTF-8&rft.au=Richard+T.+LeGates&rft.aufirst=Richard+T.&rft.aulast=LeGates&rft.btitle=The+city+reader&rft.date=2011&rft.eisbn=0-203-86926-5&rft.eisbn_additional=9786613045386&rft.genre=book&rft.isbn=9780415556644&rft.isbn_additional=978-0-415-55664-4&rft.language=eng&rft.lccn=2010027851&rft.object_id=2560000000061550&rft.oclcnum=712654434&rft.place=London+;+New+York&rft.primo=dedupmrg52787609&rft.pub=Routledge&rft.stitle=CITY+READER+:+ROUTLEDGE+URBAN+READER+SERIES&rft.title=The+city+reader&rft.tpages=624&rft_val_fmt=info:ofi/fmt:kev:mtx:book&rfr_id=info:sid/primo.exlibrisgroup.com:primo-dedupmrg52787609,Book | The city reader | Richard T LeGates 2011 |  | Publisher:Routledge ISBN:9780415556644,0,0,1,0,1,1,0,100,0,0,0,0,0
getit.library.nyu.edu/resolve?umlaut.referent_id=18980804&url_ver=Z39.88-2004&url_ctx_fmt=info:ofi/fmt:kev:mtx:ctx&ctx_ver=Z39.88-2004&ctx_tim=2022-05-11T01:40:08-04:00&ctx_id=&ctx_enc=info:ofi/enc:UTF-8&rft.au=Richard+T.+LeGates&rft.aufirst=Richard+T.&rft.aulast=LeGates&rft.btitle=The+city+reader&rft.date=2011&rft.eisbn=0-203-86926-5&rft.eisbn_additional=9786613045386&rft.genre=book&rft.isbn=9780415556644&rft.isbn_additional=978-0-415-55664-4&rft.language=eng&rft.lccn=2010027851&rft.object_id=2560000000061550&rft.oclcnum=712654434&rft.place=London+;+New+York&rft.primo=dedupmrg52787609&rft.pub=Routledge&rft.stitle=CITY+READER+:+ROUTLEDGE+URBAN+READER+SERIES&rft.title=The+city+reader&rft.tpages=624&rft_val_fmt=info:ofi/fmt:kev:mtx:book&rfr_id=info:sid/primo.exlibrisgroup.com:primo-dedupmrg52787609,Book | The city reader | Richard T LeGates 2011 |  | Publisher:Routledge ISBN:9780415556644,0,0,1,0,1,1,0,100,0,0,0,0,0
getit.library.nyu.edu/resolve?umlaut.referent_id=18980804&url_ver=Z39.88-2004&url_ctx_fmt=info:ofi/fmt:kev:mtx:ctx&ctx_ver=Z39.88-2004&ctx_tim=2022-05-11T11:09:05-04:00&ctx_id=&ctx_enc=info:ofi/enc:UTF-8&rft.au=Richard+T.+LeGates&rft.aufirst=Richard+T.&rft.aulast=LeGates&rft.btitle=The+city+reader&rft.date=2011&rft.eisbn=0-203-86926-5&rft.eisbn_additional=9786613045386&rft.genre=book&rft.isbn=9780415556644&rft.isbn_additional=978-0-415-55664-4&rft.language=eng&rft.lccn=2010027851&rft.object_id=2560000000061550&rft.oclcnum=712654434&rft.place=London+;+New+York&rft.primo=dedupmrg52787609&rft.pub=Routledge&rft.stitle=CITY+READER+:+ROUTLEDGE+URBAN+READER+SERIES&rft.title=The+city+reader&rft.tpages=624&rft_val_fmt=info:ofi/fmt:kev:mtx:book&rfr_id=info:sid/primo.exlibrisgroup.com:primo-dedupmrg52787609,Book | The city reader | Richard T LeGates 2011 |  | Publisher:Routledge ISBN:9780415556644,0,0,1,0,1,1,0,100,0,0,0,0,0
getit.library.nyu.edu/resolve?umlaut.referent_id=18980804&url_ver=Z39.88-2004&url_ctx_fmt=info:ofi/fmt:kev:mtx:ctx&ctx_ver=Z39.88-2004&ctx_tim=2022-05-11T14:22:26-04:00&ctx_id=&ctx_enc=info:ofi/enc:UTF-8&rft.au=Richard+T.+LeGates&rft.aufirst=Richard+T.&rft.aulast=LeGates&rft.btitle=The+city+reader&rft.date=2011&rft.eisbn=0-203-86926-5&rft.eisbn_additional=9786613045386&rft.genre=book&rft.isbn=9780415556644&rft.isbn_additional=978-0-415-55664-4&rft.language=eng&rft.lccn=2010027851&rft.object_id=2560000000061550&rft.oclcnum=712654434&rft.place=London+;+New+York&rft.primo=dedupmrg52787609&rft.pub=Routledge&rft.stitle=CITY+READER+:+ROUTLEDGE+URBAN+READER+SERIES&rft.title=The+city+reader&rft.tpages=624&rft_val_fmt=info:ofi/fmt:kev:mtx:book&rfr_id=info:sid/primo.exlibrisgroup.com:primo-dedupmrg52787609,Book | The city reader | Richard T LeGates 2011 |  | Publisher:Routledge ISBN:9780415556644,0,0,1,0,1,1,0,100,0,0,0,0,0
getit.library.nyu.edu/resolve?umlaut.referent_id=18980804&url_ver=Z39.88-2004&url_ctx_fmt=info:ofi/fmt:kev:mtx:ctx&ctx_ver=Z39.88-2004&ctx_tim=2022-05-11T14:50:02-04:00&ctx_id=&ctx_enc=info:ofi/enc:UTF-8&rft.au=Richard+T.+LeGates&rft.aufirst=Richard+T.&rft.aulast=LeGates&rft.btitle=The+city+reader&rft.date=2011&rft.eisbn=0-203-86926-5&rft.eisbn_additional=9786613045386&rft.genre=book&rft.isbn=9780415556644&rft.isbn_additional=978-0-415-55664-4&rft.language=eng&rft.lccn=2010027851&rft.object_id=2560000000061550&rft.oclcnum=712654434&rft.place=London+;+New+York&rft.primo=dedupmrg52787609&rft.pub=Routledge&rft.stitle=CITY+READER+:+ROUTLEDGE+URBAN+READER+SERIES&rft.title=The+city+reader&rft.tpages=624&rft_val_fmt=info:ofi/fmt:kev:mtx:book&rfr_id=info:sid/primo.exlibrisgroup.com:primo-dedupmrg52787609,Book | The city reader | Richard T LeGates 2011 |  | Publisher:Routledge ISBN:9780415556644,0,0,1,0,1,1,0,100,0,0,0,0,0
getit.library.nyu.edu/resolve?url_ver=Z39.88-2004&rft.genre=article&rfr_id=info:sid/wiley&rft.aufirst=A.&rft.aulast=Bachtold&rft.aufirst=P.&rft.aulast=Hadley&rft.aufirst=T.&rft.aulast=Nakanishi&rft.aufirst=C.&rft.aulast=Dekker&rft.jtitle=Science&rft.date=2001&rft.volume=294&rft.spage=1317&rft.epage=1320,Article |   | Bachtold A 2001 | Published in Journal Volume 294 Page 1317 1320. | ISSN:0368-6396,1,0,20,1,21,22,5,95,0,0,0,0,0
getit.library.nyu.edu/resolve?url_ver=Z39.88-2004&rft.genre=article&rfr_id=info:sid/wiley&rft.aufirst=B. J.&rft.aulast=Lane&rft.aufirst=D. I.&rft.aulast=Rae&rft.date=1983&rft.atitle=The prejudice of language: Effects of word choice on impressions formed by nurses&rft.jtitle=Canadian Journal of Nursing Research&rft.volume=15&rft.issue=1&rft.spage=21&rft.epage=33,Article | The prejudice of language Effects of word choice on impressions formed by nurses | Lane B J 1983 | Published in Journal Canadian Journal of Nursing Research Volume 15 Issue 1 Page 21 33. | ISSN:0844-5621,0,0,1,0,1,1,0,100,0,0,0,0,0
getit.library.nyu.edu/resolve?url_ver=Z39.88-2004&rft.genre=article&rfr_id=info:sid/wiley&rft.aufirst=M. J.&rft.aulast=Gelfand&rft.aufirst=J. L.&rft.aulast=Raver&rft.aufirst=L.&rft.aulast=Nishii&rft.aufirst=L. M.&rft.aulast=Leslie&rft.aufirst=J.&rft.aulast=Lun&rft.aufirst=B. C.&rft.aulast=Lim&rft.aufirst=S.&rft.aulast=Yamaguchi&rft.date=2011&rft.atitle=Differences between tight and loose cultures: A 33\u2010nation study&rft.jtitle=Science&rft.volume=332&rft.issue=6033&rft.spage=1100&rft.epage=1104,Article | Differences between tight and loose cultures A 33\u2010nation study | Gelfand M J 2011 | Published in Journal Science Online Volume 332 Issue 6033 Page 1100 1104. | ISSN:2797-0744,1,0,12,1,13,14,7,93,0,0,0,0,0
"getit.library.nyu.edu/resolve?url_ver=Z39.88-2004&rft.genre=article&rfr_id=info:sid/wiley&rft.aufirst=R. G.&rft.aulast=Harrison&rft.aufirst=E. L.&rft.aulast=Larson&rft.date=2014&rft.atitle=Hybridization, introgression, and the nature of species boundaries&rft.jtitle=The Journal of Heredity&rft.volume=105&rft.issue=Suppl 1&rft.spage=795&rft.epage=809",Article | Hybridization introgression and the nature of species boundaries | Harrison R G 2014 | Published in Journal JOURNAL OF HEREDITY Volume 105 Issue Suppl 1 Page 795 809. | ISSN:0022-1503,2,0,0,2,2,4,50,50,0,0,0,0,0
getit.library.nyu.edu/resolve?url_ver=Z39.88-2004&rft.genre=article&rfr_id=info:sid/wiley&rft.aufirst=Robin&rft.aulast=Greenwood&rft.aufirst=Dimitri&rft.aulast=Vayanos&rft.date=2010&rft.atitle=Price pressure in the government bond market&rft.jtitle=American Economic Review&rft.volume=100&rft.spage=585&rft.epage=590,Article | Price pressure in the government bond market | Greenwood Robin 2010 | Published in Journal AMERICAN ECONOMIC REVIEW Volume 100 Page 585 590. | ISSN:0002-8282,4,0,0,4,4,8,50,50,0,0,0,0,0
getit.library.nyu.edu/resolve?url_ver=Z39.88-2004&rft.genre=article&rfr_id=info:sid/wiley&rft.aufirst=Y&rft.aulast=Takarada&rft.aufirst=H&rft.aulast=Takazawa&rft.aufirst=Y&rft.aulast=Sato&rft.aufirst=S&rft.aulast=Takebayashi&rft.aufirst=Y&rft.aulast=Tanaka&rft.aufirst=N&rft.aulast=Ishii&rft.atitle=Effects of resistance exercise combined with moderate vascular occlusion on muscular function in humans&rft.jtitle=J Appl Physiol&rft.date=2000&rft.volume=88&rft.spage=2097&rft.epage=2106,Article | Effects of resistance exercise combined with moderate vascular occlusion on muscular function in humans | Takarada Y 2000 | Published in Journal JOURNAL OF APPLIED PHYSIOLOGY Volume 88 Page 2097 2106. | ISSN:8750-7587,1,0,1,1,2,3,33,67,0,0,0,0,0
getit.library.nyu.edu/resolve?url_ver=Z39.88-2004&rft.genre=book&rfr_id=info:sid/wiley&rft.aufirst=Laurajane&rft.aulast=Smith&rft.date=2006&rft.btitle=Uses of Heritage&rft.pub=Routledge,Book | Uses of Heritage | Smith Laurajane 2006 |  | Publisher:Routledge,0,0,2,0,2,2,0,100,0,0,0,0,0
getit.library.nyu.edu/resolve?url_ver=Z39.88-2004&rft_id=info:doi/10.1002/(SICI)1099-1166(200001)15:1<86::AID-GPS124>3.0.CO;2-8&rfr_id=info:sid/wiley&rft.genre=article&rft.date=2000&rft.atitle=The+role+of+occupational+therapy+in+dementia\u2014C.O.P.E.+(Caregiver+Options+for+Practical+Experiences)&rft.jtitle=International+Journal+of+Geriatric+Psychiatry&rft.title=International+Journal+of+Geriatric+Psychiatry&rft.volume=15&rft.issue=1&rft.spage=86&rft.epage=89&rft.issn=0885-6230,Article | The role of occupational therapy in dementia\u2014C.O.P.E Caregiver Options for Practical Experiences) | 2000 | Published in Journal International Journal of Geriatric Psychiatry Volume 15 Issue 1 Page 86 89. | ISSN:0885-6230,0,0,1,0,1,1,0,100,0,0,0,0,0
getit.library.nyu.edu/resolve?url_ver=Z39.88-2004&rft_id=info:doi/10.1002/(SICI)1521-4141(199908)29:08<2625::AID-IMMU2625>3.0.CO;2-5&rfr_id=info:sid/wiley&rft.genre=article&rft.date=1999&rft.atitle=Obligatory+cross\u2010talk+with+the+tyrosine+kinases+assembled+with+the+TCR/CD3+complex+in+CD4+signal+transduction&rft.jtitle=European+Journal+of+Immunology&rft.title=European+Journal+of+Immunology&rft.volume=29&rft.issue=8&rft.spage=2625&rft.epage=2635&rft.issn=0014-2980,Article | Obligatory cross\u2010talk with the tyrosine kinases assembled with the TCR/CD3 complex in CD4 signal transduction | 1999 | Published in Journal European Journal of Immunology Volume 29 Issue 8 Page 2625 2635. | ISSN:0014-2980,0,1,1,1,1,2,50,50,0,0,0,0,0
getit.library.nyu.edu/resolve?url_ver=Z39.88-2004&rft_id=info:doi/10.1002/1096-8628(200022)97:2<119::AID-AJMG3>3.0.CO;2-3&rfr_id=info:sid/wiley&rft.genre=article&rft.date=2000&rft.atitle=Neurofibromatosis+Type+1&rft.jtitle=American+Journal+of+Medical+Genetics&rft.title=American+Journal+of+Medical+Genetics&rft.volume=97&rft.issue=2&rft.spage=119&rft.epage=127&rft.issn=0148-7299,Article | Neurofibromatosis Type 1 | 2000 | Published in Journal American Journal of Medical Genetics Volume 97 Issue 2 Page 119 127. | ISSN:0148-7299,0,1,1,1,1,2,50,50,0,0,0,0,0
getit.library.nyu.edu/resolve?url_ver=Z39.88-2004&rft_id=info:doi/10.1002/9780470997116&rfr_id=info:sid/wiley&rft.genre=book&rft.date=2006&rft.btitle=A+Companion+to+American+Immigration&rft.title=A+Companion+to+American+Immigration&rft.isbn=0-631-22843-8&rft.atitle=Characteristics+of+Immigrants+to+the+United+States:+1820\u20132003,Book Chapter | Characteristics of Immigrants to the United States 1820\u20132003 | Ueda 2006 | Published in Book A companion to American immigration. | Publisher:Blackwell Pub ISBN:0631228438,0,0,5,0,5,5,0,100,0,0,0,0,0
"getit.library.nyu.edu/resolve?url_ver=Z39.88-2004&rft_id=info:doi/10.1002/9780470997116&rfr_id=info:sid/wiley&rft.genre=book&rft.date=2006&rft.btitle=A+Companion+to+American+Immigration&rft.title=A+Companion+to+American+Immigration&rft.pub=John+Wiley+&+Sons,+Ltd=&rft.isbn=0-631-22843-8&rft.atitle=Characteristics+of+Immigrants+to+the+United+States:+1820\u20132003",Book Chapter | Characteristics of Immigrants to the United States 1820\u20132003 | Ueda 2006 | Published in Book A companion to American immigration. | Publisher:Blackwell Pub ISBN:0631228438,0,0,5,0,5,5,0,100,0,0,0,0,0
getit.library.nyu.edu/resolve?url_ver=Z39.88-2004&rft_id=info:doi/10.1002/9781444308488&rfr_id=info:sid/wiley&rft.genre=book&rft.date=2009&rft.btitle=The+Blackwell+Guide+to+Kant's+Ethics&rft.title=The+Blackwell+Guide+to+Kant's+Ethics&rft.isbn=1-4051-2581-0&rft.atitle=Good+Will+and+the+Moral+Worth+of+Acting+from+Duty,Book Chapter | Good Will and the Moral Worth of Acting from Duty | Thomas E Hill Jr 2009 | Published in Book The Blackwell guide to Kant's ethics. | Publisher:Wiley-Blackwell ISBN:1405125810,0,0,4,0,4,4,0,100,0,0,0,0,0
"getit.library.nyu.edu/resolve?url_ver=Z39.88-2004&rft_val_fmt=info:ofi/fmt:kev:mtx:book&genre=book&sid=ProQ:ProQ:ble&atitle=&title=USA+Cervantes:+39+cervantistas+en+Estados+Unidos&issn=&date=2009-01-01&volume=&issue=&spage=&au=Dopico+Black,+Georgina;Layna+Ranz,+Francisco&isbn=&jtitle=&btitle=USA+Cervantes:+39+cervantistas+en+Estados+Unidos&rft_id=info:eric/000124137&rft_id=info:doi/","Book | USA Cervantes 39 cervantistas en Estados Unidos | Dopico Black Georgina 2009 Jan 01 |  | ",0,0,1,0,1,1,0,100,0,0,0,0,0
"getit.library.nyu.edu/resolve?url_ver=Z39.88-2004&rft_val_fmt=info:ofi/fmt:kev:mtx:book&genre=book&sid=ProQ:ProQ:econlit&atitle=&title=A+Practical+Education:+Why+Liberal+Arts+Majors+Make+Great+Employees&issn=&date=2017-01-01&volume=&issue=&spage=viii&au=Stross,+Randall&isbn=9780804797481&jtitle=&btitle=A+Practical+Education:+Why+Liberal+Arts+Majors+Make+Great+Employees&rft_id=info:eric/1713366&rft_id=info:doi/",Book | A practical education why liberal arts majors make great employees | Stross Randall 2017 Jan 01 | Published in Book Page viii. | Publisher:Stanford University Press ISBN:9780804797481,0,0,2,0,2,2,0,100,0,0,0,0,0
"getit.library.nyu.edu/resolve?url_ver=Z39.88-2004&rft_val_fmt=info:ofi/fmt:kev:mtx:journal&genre=article&sid=ProQ:ProQ:abiglobal&atitle=Book+Reviews+--+Robert+Maillart+and+the+Art+of+Reinforced+Concrete+by+David+P.+Billington&title=Technology+and+Culture&issn=0040165X&date=1992-07-01&volume=33&issue=3&spage=621&au=Israel,+Paul&isbn=&jtitle=Technology+and+Culture&btitle=&rft_id=info:eric/01333597&rft_id=info:doi/",Article | Book Reviews Robert Maillart and the Art of Reinforced Concrete by David P Billington | Israel Paul 1992 Jul 01 | Published in Journal Technology and Culture Volume 33 Issue 3 Page 621. | ISSN:0040-165X,1,1,1,2,2,4,50,50,0,0,0,0,0
"getit.library.nyu.edu/resolve?url_ver=Z39.88-2004&rft_val_fmt=info:ofi/fmt:kev:mtx:journal&genre=article&sid=ProQ:ProQ:abiglobal&atitle=Implications+of+population+ageing+for+economic+growth&title=Oxford+Review+of+Economic+Policy&issn=0266903X&date=2010-12-01&volume=26&issue=4&spage=583&au=Bloom,+David+E;Canning,+David;Fink,+G\u00fcnther&isbn=&jtitle=Oxford+Review+of+Economic+Policy&btitle=&rft_id=info:eric/&rft_id=info:doi/",Article | Implications of population ageing for economic growth | Bloom David E 2010 Dec 01 | Published in Journal Oxford Review of Economic Policy Volume 26 Issue 4 Page 583. | ISSN:0266-903X,0,0,2,0,2,2,0,100,0,0,0,0,0
"getit.library.nyu.edu/resolve?url_ver=Z39.88-2004&rft_val_fmt=info:ofi/fmt:kev:mtx:journal&genre=article&sid=ProQ:ProQ:artbibliographies&atitle=Painting+skin:+John+Singer+Sargent's+Madame+X&title=American+Art+(U.S.A.)&issn=10739300&date=2001-09-01&volume=15&issue=3&spage=8&au=Sidlauskas,+Susan&isbn=&jtitle=American+Art+(U.S.A.)&btitle=&rft_id=info:eric/0001013102&rft_id=info:doi/",Article | Painting skin John Singer Sargent's Madame X | Sidlauskas Susan 2001 Sep 01 | Published in Journal American Art U.S.A Volume 15 Issue 3 Page 8. | ISSN:1073-9300,2,1,1,3,3,6,50,50,0,0,0,0,0
"getit.library.nyu.edu/resolve?url_ver=Z39.88-2004&rft_val_fmt=info:ofi/fmt:kev:mtx:journal&genre=article&sid=ProQ:ProQ:cbcacomplete&atitle=Analysis+and+interpretation+--+Songs+of+Love+and+Death:+The+Classical+American+Horror+Film+of+the+1930s+by+Michael+Sevastakis+/+Androids,+Humanoids,+and+Other+Science+Fiction+Monsters:+Science+and+Soul+in+Science+Fiction+Films+by+Per+Schelde&title=Science+-+Fiction+Studies&issn=00917729&date=1994-03-01&volume=21&issue=&spage=98&au=Fitting,+Peter&isbn=&jtitle=Science+-+Fiction+Studies&btitle=&rft_id=info:eric/01888119&rft_id=info:doi/",Article | Analysis and interpretation Songs of Love and Death The Classical American Horror Film of the 1930s by Michael Sevastakis Androids Humanoids and Other Science Fiction Monsters Science and Soul in Science Fiction Films by Per Schelde | Fitting Peter 1994 Mar 01 | Published in Journal Science Fiction Studies Volume 21 Page 98. | ISSN:0091-7729,1,2,1,3,2,5,60,40,0,0,0,0,0
"getit.library.nyu.edu/resolve?url_ver=Z39.88-2004&rft_val_fmt=info:ofi/fmt:kev:mtx:journal&genre=article&sid=ProQ:ProQ:econlit&atitle=Curbside+Recycling:+Waste+Resource+or+Waste+of+Resources?&title=Journal+of+Policy+Analysis+and+Management&issn=02768739&date=2006-10-01&volume=25&issue=4&spage=855&au=Aadland,+David;Caplan,+Arthur+J&isbn=&jtitle=Journal+of+Policy+Analysis+and+Management&btitle=&rft_id=info:eric/1230984&rft_id=info:doi/",Article | Curbside Recycling Waste Resource or Waste of Resources? | Aadland David 2006 Oct 01 | Published in Journal Journal of Policy Analysis and Management Volume 25 Issue 4 Page 855. | ISSN:0276-8739,2,2,1,4,3,7,57,43,0,0,0,0,0
"getit.library.nyu.edu/resolve?url_ver=Z39.88-2004&rft_val_fmt=info:ofi/fmt:kev:mtx:journal&genre=article&sid=ProQ:ProQ:econlit&atitle=Imperfect+Competition+in+Multiproduct+Food+Industries+with+Application+to+Pear+Processing&title=American+Journal+of+Agricultural+Economics&issn=00029092&date=1992-11-01&volume=74&issue=4&spage=980&au=Wann,+Joyce+J;Sexton,+Richard+J&isbn=&jtitle=American+Journal+of+Agricultural+Economics&btitle=&rft_id=info:eric/0293451&rft_id=info:doi/",Article | Imperfect Competition in Multiproduct Food Industries with Application to Pear Processing | Wann Joyce J 1992 Nov 01 | Published in Journal American Journal of Agricultural Economics Volume 74 Issue 4 Page 980. | ISSN:0002-9092,0,0,4,0,4,4,0,100,0,0,0,0,0
"getit.library.nyu.edu/resolve?url_ver=Z39.88-2004&rft_val_fmt=info:ofi/fmt:kev:mtx:journal&genre=article&sid=ProQ:ProQ:econlit&atitle=Trends+in+Deep+Poverty+from+1968+to+2011:+The+Influence+of+Family+Structure,+Employment+Patterns,+and+the+Safety+Net&title=RSF:+The+Russell+Sage+Foundation+Journal+of+the+Social+Sciences&issn=23778253&date=2015-11-01&volume=1&issue=1&spage=14&au=Fox,+Liana;Wimer,+Christopher;Garfinkel,+Irwin;Kaushal,+Neeraj;Nam,+JaeHyun;Waldfogel,+Jane&isbn=&jtitle=RSF:+The+Russell+Sage+Foundation+Journal+of+the+Social+Sciences&btitle=&rft_id=info:eric/1666930&rft_id=info:doi/",Article | Trends in Deep Poverty from 1968 to 2011 The Influence of Family Structure Employment Patterns and the Safety Net | Fox Liana 2015 Nov 01 | Published in Journal RSF The Russell Sage Foundation Journal of the Social Sciences Volume 1 Issue 1 Page 14. | ISSN:2377-8253,0,0,6,0,6,6,0,100,0,0,0,0,0
"getit.library.nyu.edu/resolve?url_ver=Z39.88-2004&rft_val_fmt=info:ofi/fmt:kev:mtx:journal&genre=article&sid=ProQ:ProQ:econlit&atitle=Why+Brexit?+The+Toxic+Mix+of+Immigration+and+Austerity&title=Population+and+Development+Review&issn=00987921&date=2016-12-01&volume=42&issue=4&spage=673&au=Gietel-Basten,+Stuart&isbn=&jtitle=Population+and+Development+Review&btitle=&rft_id=info:eric/1642488&rft_id=info:doi/",Article | Why Brexit The Toxic Mix of Immigration and Austerity | Gietel-Basten Stuart 2016 Dec 01 | Published in Journal Population and Development Review Volume 42 Issue 4 Page 673. | ISSN:0098-7921,0,0,3,0,3,3,0,100,0,0,0,0,0
"getit.library.nyu.edu/resolve?url_ver=Z39.88-2004&rft_val_fmt=info:ofi/fmt:kev:mtx:journal&genre=article&sid=ProQ:ProQ:eric&atitle=The+Evolving+Roles+of+Faculty+Learning+Communities:+A+University/High+School+Literacy+Partnership&title=Theory+Into+Practice&issn=00405841&date=2008-10-01&volume=47&issue=4&spage=327&au=Jetton,+Tamara+L.;Cancienne,+Mary+Beth;Greever,+Brenda&isbn=&jtitle=Theory+Into+Practice&btitle=&rft_id=info:eric/EJ813230&rft_id=info:doi/",Article | The Evolving Roles of Faculty Learning Communities A University/High School Literacy Partnership | Jetton Tamara L 2008 Oct 01 | Published in Journal Theory Into Practice Volume 47 Issue 4 Page 327. | ISSN:0040-5841,2,5,1,7,3,10,70,30,0,0,0,0,0
"getit.library.nyu.edu/resolve?url_ver=Z39.88-2004&rft_val_fmt=info:ofi/fmt:kev:mtx:journal&genre=article&sid=ProQ:ProQ:europeannews&atitle=I+Love+One+Direction:+A+new+documentary+meets+the+1D+fans+who+are+so+obsessed+with+the+fab+five,+they're+even+willing+to+go+to+jail+for+them&title=The+Sun&issn=&date=2013-08-10&volume=&issue=&spage=8&au=Grady,+Oliver&isbn=&jtitle=The+Sun&btitle=&rft_id=info:eric/&rft_id=info:doi/",Article | I Love One Direction A new documentary meets the 1D fans who are so obsessed with the fab five they're even willing to go to jail for them | Grady Oliver 2013 Aug 10 | Published in Journal The Sun Page 8. | ISSN:1394-0813,0,0,24,0,24,24,0,100,0,0,0,0,0
getit.library.nyu.edu/resolve?url_ver=Z39.88-2004&rft_val_fmt=info:ofi/fmt:kev:mtx:journal&genre=article&sid=ProQ:ProQ:globalwires&atitle=Belgium+Investigates+Large-Scale+Cyberattack+on+State+Agencies+&ndash;+Prosecutor=&rsquo;s+Office=&title=Sputnik&issn=&date=2021-05-06&volume=&issue=&spage=&au=&isbn=&jtitle=Sputnik&btitle=&rft_id=info:eric/&rft_id=info:doi/,Article | Belgium Investigates Large-Scale Cyberattack on State Agencies | 2021 May 06 | Published in Journal Sputnik. | ISSN:0131-8748,1,0,2,1,3,4,25,75,0,0,0,0,0
"getit.library.nyu.edu/resolve?url_ver=Z39.88-2004&rft_val_fmt=info:ofi/fmt:kev:mtx:journal&genre=article&sid=ProQ:ProQ:ibss&atitle=To+steal+a+book+is+an+elegant+offense:+intellectual+property+law+in+Chinese+civilization&title=China+quarterly&issn=00094439&date=1999-09-01&volume=159&issue=&spage=748&au=Alford,+William+P;Lubman,+Stanley&isbn=&jtitle=China+quarterly&btitle=&rft_id=info:eric/1872837&rft_id=info:doi/",Article | To steal a book is an elegant offense intellectual property law in Chinese civilization | Alford William P 1999 Sep 01 | Published in Journal China quarterly Volume 159 Page 748. | ISSN:0305-7410,0,0,3,0,3,3,0,100,0,0,0,0,0
"getit.library.nyu.edu/resolve?url_ver=Z39.88-2004&rft_val_fmt=info:ofi/fmt:kev:mtx:journal&genre=article&sid=ProQ:ProQ:iimpft&atitle=Changing+Tunes:+The+Use+of+Pre-existing+Music+in+Film&title=Music+&+Letters=&issn=00274224&date=2007-11-01&volume=88&issue=4&spage=698&au=Citron,+Marcia+J&isbn=&jtitle=Music+&+Letters=&btitle=&rft_id=info:eric/&rft_id=info:doi/",Article | Changing Tunes The Use of Pre-existing Music in Film | Citron Marcia J 2007 Nov 01 | Published in Journal Music Volume 88 Issue 4 Page 698. | ISSN:0027-4224,2,3,2,5,4,9,56,44,0,0,0,0,0
"getit.library.nyu.edu/resolve?url_ver=Z39.88-2004&rft_val_fmt=info:ofi/fmt:kev:mtx:journal&genre=article&sid=ProQ:ProQ:indexislamicus&atitle=La+costruzione+dei+primi+villaggi+agricoli+della+Cirenaica+nella+sezione+fotografica+dell'Archivio+dell'Ente+per+la+Colonizzazione+della+Libia&title=Africa+(Istituto+Italiano+per+l'Africa+e+l'Oriente)&issn=00019747&date=2007-01-01&volume=62&issue=1&spage=107&au=Cresti,+Federico&isbn=&jtitle=Africa+(Istituto+Italiano+per+l'Africa+e+l'Oriente)&btitle=&rft_id=info:eric/A350390&rft_id=info:doi/",Article | La costruzione dei primi villaggi agricoli della Cirenaica nella sezione fotografica dell'Archivio dell'Ente per la Colonizzazione della Libia | Cresti Federico 2007 Jan 01 | Published in Journal Africa Istituto Italiano per l'Africa e l'Oriente Volume 62 Issue 1 Page 107. | ISSN:0001-9747,0,1,1,1,1,2,50,50,0,0,0,0,0
"getit.library.nyu.edu/resolve?url_ver=Z39.88-2004&rft_val_fmt=info:ofi/fmt:kev:mtx:journal&genre=article&sid=ProQ:ProQ:indexislamicus&atitle=La+guerre+italo-turque+en+Tripolitaine+(1911-1912)+et+la+Hongrie&title=Africa+(Istituto+Italiano+per+l'Africa+e+l'Oriente)&issn=00019747&date=2008-01-01&volume=63&issue=2&spage=325&au=Nagy,+L\u00e1szl\u00f3&isbn=&jtitle=Africa+(Istituto+Italiano+per+l'Africa+e+l'Oriente)&btitle=&rft_id=info:eric/A405725&rft_id=info:doi/",Article | La guerre italo-turque en Tripolitaine 1911-1912 et la Hongrie | Nagy L\u00e1szl\u00f3 2008 Jan 01 | Published in Journal Africa Istituto Italiano per l'Africa e l'Oriente Volume 63 Issue 2 Page 325. | ISSN:0001-9747,0,1,1,1,1,2,50,50,0,0,0,0,0
"getit.library.nyu.edu/resolve?url_ver=Z39.88-2004&rft_val_fmt=info:ofi/fmt:kev:mtx:journal&genre=article&sid=ProQ:ProQ:lionjournals&atitle=Books+briefly+noted+--+Jane+Austen's+Letters:+Third+Edition+by+Jane+Austen+and+edited+by+Deirdre+Le+Faye:+A+Journal+of+Victorian+Fiction&title=Nineteenth+-+Century+Literature&issn=08919356&date=1995-12-01&volume=50&issue=3&spage=413&au=Tennyson,+G+B;Wortham,+Thomas&isbn=&jtitle=Nineteenth+-+Century+Literature&btitle=&rft_id=info:eric/02651783&rft_id=info:doi/",Article | Books briefly noted Jane Austen's Letters Third Edition by Jane Austen and edited by Deirdre Le Faye A Journal of Victorian Fiction | Tennyson G B 1995 Dec 01 | Published in Journal Nineteenth Century Literature Volume 50 Issue 3 Page 413. | ISSN:0891-9356,0,1,1,1,1,2,50,50,0,0,0,0,0
"getit.library.nyu.edu/resolve?url_ver=Z39.88-2004&rft_val_fmt=info:ofi/fmt:kev:mtx:journal&genre=article&sid=ProQ:ProQ:llba&atitle=Esperanto:+In+Search+of+a+Universal+Language&title=Glotta&issn=00171298&date=1990-12-01&volume=5&issue=3&spage=28&au=Bolanos+Cuellar,+Sergio&isbn=&jtitle=Glotta&btitle=&rft_id=info:eric/9104090&rft_id=info:doi/",Article | Esperanto In Search of a Universal Language | Bolanos Cuellar Sergio 1990 Dec 01 | Published in Journal Glotta Volume 5 Issue 3 Page 28. | ISSN:0017-1298,2,1,1,3,3,6,50,50,0,0,0,0,0
"getit.library.nyu.edu/resolve?url_ver=Z39.88-2004&rft_val_fmt=info:ofi/fmt:kev:mtx:journal&genre=article&sid=ProQ:ProQ:midwestnews1&atitle=In+Thailand,+sidewalks+are+chefs'+kitchens:+[FIVE+STAR+SPORTS+FINAL+Edition]&title=Chicago+Sun+-+Times&issn=&date=1990-08-09&volume=&issue=&spage=5&au=Raichlen,+Steven&isbn=&jtitle=Chicago+Sun+-+Times&btitle=&rft_id=info:eric/&rft_id=info:doi/","Article | In Thailand sidewalks are chefs kitchens FIVE STAR SPORTS FINAL Edition] | Raichlen Steven 1990 Aug 09 | Published in Journal Chicago Sun Times Page 5. | ",0,0,1,0,1,1,0,100,0,0,0,0,0
"getit.library.nyu.edu/resolve?url_ver=Z39.88-2004&rft_val_fmt=info:ofi/fmt:kev:mtx:journal&genre=article&sid=ProQ:ProQ:military&atitle=Distant+neighbors+--+The+United+States+and+the+Origins+of+the+Cuban+Revolution+by+Jules+R.+Benjamin+/+A+Hemisphere+Apart+by+John+J.+Johnson+/+Mexico+and+the+United+States+by+Lester+D.+Langley+/+Chile+and+the+United+States+by+William+F.+Sater+/+and+others&title=Diplomatic+History&issn=01452096&date=1994-10-01&volume=18&issue=4&spage=541&au=Pach,+Chester+J,+Jr&isbn=&jtitle=Diplomatic+History&btitle=&rft_id=info:eric/02116851&rft_id=info:doi/",Article | Distant neighbors The United States and the Origins of the Cuban Revolution by Jules R Benjamin A Hemisphere Apart by John J Johnson Mexico and the United States by Lester D Langley Chile and the United States by William F Sater and others | Pach Chester J Jr 1994 Oct 01 | Published in Journal Diplomatic History Volume 18 Issue 4 Page 541. | ISSN:0145-2096,3,1,1,4,4,8,50,50,0,0,0,0,0
getit.library.nyu.edu/resolve?url_ver=Z39.88-2004&rft_val_fmt=info:ofi/fmt:kev:mtx:journal&genre=article&sid=ProQ:ProQ:pais&atitle=The+changing+board:+profile+of+the+board+of+directors+[a+survey+of+board+practices+in+leading+United+States+companies]&title=Directors+and+Boards&issn=03649156&date=1979-01-01&volume=3&issue=&spage=49&au=&isbn=&jtitle=Directors+and+Boards&btitle=&rft_id=info:eric/1978-0345166&rft_id=info:doi/,Article | The changing board profile of the board of directors a survey of board practices in leading United States companies] | 1979 Jan 01 | Published in Journal Directors and Boards Volume 3 Page 49. | ISSN:0364-9156,1,0,0,1,1,2,50,50,0,0,0,0,0
"getit.library.nyu.edu/resolve?url_ver=Z39.88-2004&rft_val_fmt=info:ofi/fmt:kev:mtx:journal&genre=article&sid=ProQ:ProQ:philosophersindex&atitle=Art+and+Ethical+Criticism:+An+Overview+of+Recent+Directions+of+Research&title=Ethics:+An+International+Journal+of+Social,+Political,+and+Legal+Philosophy&issn=00141704&date=2000-01-01&volume=110&issue=2&spage=350&au=Carroll,+No\u00ebl&isbn=&jtitle=Ethics:+An+International+Journal+of+Social,+Political,+and+Legal+Philosophy&btitle=&rft_id=info:eric/1675664&rft_id=info:doi/",Article | Art and Ethical Criticism An Overview of Recent Directions of Research | Carroll No\u00ebl 2000 Jan 01 | Published in Journal Ethics An International Journal of Social Political and Legal Philosophy Volume 110 Issue 2 Page 350. | ISSN:0014-1704,0,0,3,0,3,3,0,100,0,0,0,0,0
"getit.library.nyu.edu/resolve?url_ver=Z39.88-2004&rft_val_fmt=info:ofi/fmt:kev:mtx:journal&genre=article&sid=ProQ:ProQ:pio&atitle=BOKOLANFINI:+MUD+CLOTH+OF+THE+BAMANA+OF+MALI&title=African+Arts&issn=00019933&date=1970-07-01&volume=3&issue=4&spage=32&au=Imperato,+Pascal+James;Shamir,+Marli&isbn=&jtitle=African+Arts&btitle=&rft_id=info:eric/&rft_id=info:doi/",Article | BOKOLANFINI MUD CLOTH OF THE BAMANA OF MALI | Imperato Pascal James 1970 Jul 01 | Published in Journal African Arts Volume 3 Issue 4 Page 32. | ISSN:0001-9933,1,1,1,2,2,4,50,50,0,0,0,0,0
"getit.library.nyu.edu/resolve?url_ver=Z39.88-2004&rft_val_fmt=info:ofi/fmt:kev:mtx:journal&genre=article&sid=ProQ:ProQ:politicalscience&atitle=Black+Flesh+Female:+Zakiyyah+Iman+Jackson's+Becoming+Human:+Matter+and+Meaning+in+an+Antiblack+World&title=Theory+&+Event=&issn=25726633&date=2021-10-01&volume=24&issue=4&spage=1150&au=Ferguson,+Kennan&isbn=&jtitle=Theory+&+Event=&btitle=&rft_id=info:eric/&rft_id=info:doi/",Article | Black Flesh Female Zakiyyah Iman Jackson's Becoming Human Matter and Meaning in an Antiblack World | Ferguson Kennan 2021 Oct 01 | Published in Journal Theory Volume 24 Issue 4 Page 1150. | ISSN:1092-311X,2,1,1,3,3,6,50,50,0,0,0,0,0
"getit.library.nyu.edu/resolve?url_ver=Z39.88-2004&rft_val_fmt=info:ofi/fmt:kev:mtx:journal&genre=article&sid=ProQ:ProQ:politicalscience&atitle=Precarity/Coloniality&title=Theory+&+Event=&issn=25726633&date=2021-10-01&volume=13&issue=&spage=297&au=Kil,+Sang+H;Menj\u00edvar,+Cecilia;Doty,+Roxanne+L&isbn=&jtitle=Sociology+of+Crime,+Law+and+Deviance&btitle=&rft_id=info:eric/&rft_id=info:doi/10.1108/S1521-6136(2009)0000013019",Article | Precarity/Coloniality | Kil Sang H 2021 Oct 01 | Published in Journal Immigration crime and justice Volume 13 Page 297 312. | ISSN:1521-6136 ISBN:1848554389,1,0,3,1,4,5,20,80,0,0,0,0,0
"getit.library.nyu.edu/resolve?url_ver=Z39.88-2004&rft_val_fmt=info:ofi/fmt:kev:mtx:journal&genre=article&sid=ProQ:ProQ:pqrl&atitle=The+Art+of+Revolt:+Rebellion+in+the+Works+of+Bertran+de+Born+and+Julia+Kristeva&title=Comparative+Literature&issn=00104124&date=2010-01-01&volume=62&issue=1&spage=22&au=Sunderland,+Luke&isbn=&jtitle=Comparative+Literature&btitle=&rft_id=info:eric/&rft_id=info:doi/",Article | The Art of Revolt Rebellion in the Works of Bertran de Born and Julia Kristeva | Sunderland Luke 2010 Jan 01 | Published in Journal Comparative Literature Volume 62 Issue 1 Page 22. | ISSN:0010-4124,2,2,1,4,3,7,57,43,0,0,0,0,0
"getit.library.nyu.edu/resolve?url_ver=Z39.88-2004&rft_val_fmt=info:ofi/fmt:kev:mtx:journal&genre=article&sid=ProQ:ProQ:prismahapi&atitle=Race+and+Identity+across+American+Borders+(Review+article)&title=Latin+American+Research+Review+(Electronic+journal)&issn=15424278&date=2018-01-01&volume=53&issue=3&spage=679&au=Meeks,+Eric+V.&isbn=&jtitle=Latin+American+Research+Review+(Electronic+journal)&btitle=&rft_id=info:eric/348331&rft_id=info:doi/",Article | Race and Identity across American Borders Review article) | Meeks Eric V 2018 Jan 01 | Published in Journal Latin American Research Review Electronic journal Volume 53 Issue 3 Page 679. | ISSN:0023-8791,7,4,2,11,9,20,55,45,0,0,0,0,0
"getit.library.nyu.edu/resolve?url_ver=Z39.88-2004&rft_val_fmt=info:ofi/fmt:kev:mtx:journal&genre=article&sid=ProQ:ProQ:psychology&atitle=Our+Vampires,+Ourselves+/+Evil+Sisters:+The+Threat+of+Female+Sexuality+and+the+Cult+of+Manhood&title=Signs&issn=00979740&date=1999-04-01&volume=24&issue=3&spage=782&au=Latham,+Rob&isbn=&jtitle=Signs&btitle=&rft_id=info:eric/04328129&rft_id=info:doi/",Article | Our Vampires Ourselves Evil Sisters The Threat of Female Sexuality and the Cult of Manhood | Latham Rob 1999 Apr 01 | Published in Journal Signs Volume 24 Issue 3 Page 782. | ISSN:0097-9740,2,1,1,3,3,6,50,50,0,0,0,0,0
"getit.library.nyu.edu/resolve?url_ver=Z39.88-2004&rft_val_fmt=info:ofi/fmt:kev:mtx:journal&genre=article&sid=ProQ:ProQ:socabs&atitle=Developing+Visual+Literacy:+Use+of+Magazine+Advertisements+Depicting+Gender+Roles&title=Teaching+Sociology&issn=0092055X&date=1983-04-01&volume=10&issue=3&spage=361&au=Curry,+Timothy+Jon;Clarke,+Alfred+C&isbn=&jtitle=Teaching+Sociology&btitle=&rft_id=info:eric/83N0541&rft_id=info:doi/",Article | Developing Visual Literacy Use of Magazine Advertisements Depicting Gender Roles | Curry Timothy Jon 1983 Apr 01 | Published in Journal Teaching Sociology Volume 10 Issue 3 Page 361. | ISSN:0092-055X,1,1,1,2,2,4,50,50,0,0,0,0,0
"getit.library.nyu.edu/resolve?url_ver=Z39.88-2004&rft_val_fmt=info:ofi/fmt:kev:mtx:journal&genre=article&sid=ProQ:ProQ:socabs&atitle=Radical+Animal+Rights+and+Environmental+Activism+as+Rites+of+Passage&title=Journal+of+Ritual+Studies&issn=08901112&date=2013-01-01&volume=27&issue=1&spage=35&au=Pike,+Sarah+M&isbn=&jtitle=Journal+of+Ritual+Studies&btitle=&rft_id=info:eric/201343147&rft_id=info:doi/",Article | Radical Animal Rights and Environmental Activism as Rites of Passage | Pike Sarah M 2013 Jan 01 | Published in Journal Journal of Ritual Studies Volume 27 Issue 1 Page 35. | ISSN:0890-1112,0,1,1,1,1,2,50,50,0,0,0,0,0
"getit.library.nyu.edu/resolve?url_ver=Z39.88-2004&rft_val_fmt=info:ofi/fmt:kev:mtx:journal&genre=article&sid=ProQ:ProQ:socabs&atitle=Religiosity+and+Attitudes+Toward+Treatment+for+Mental+Health+in+the+Black+Church&title=Race+and+Social+Problems&issn=18671748&date=2021-09-01&volume=13&issue=3&spage=226&au=Davenport,+Alexandria+D;McClintock,+Heather+F&isbn=&jtitle=Race+and+Social+Problems&btitle=&rft_id=info:eric/&rft_id=info:doi/10.1007/s12552-020-09311-2",Article | Religiosity and Attitudes Toward Treatment for Mental Health in the Black Church | Davenport Alexandria D 2021 Sep 01 | Published in Journal Race and Social Problems Volume 13 Issue 3 Page 226 233. | ISSN:1867-1748,3,0,0,3,3,6,50,50,0,0,0,0,0
"getit.library.nyu.edu/resolve?url_ver=Z39.88-2004&rft_val_fmt=info:ofi/fmt:kev:mtx:journal&genre=article&sid=ProQ:ProQ:socabs&atitle=The+Sense+of+History:+On+the+Political+Implications+of+Karl+Lowith's+Concept+of+Secularization&title=History+and+Theory&issn=00182656&date=1998-02-01&volume=37&issue=1&spage=69&au=Barash,+Jeffrey+Andrew&isbn=&jtitle=History+and+Theory&btitle=&rft_id=info:eric/9900246&rft_id=info:doi/",Article | The Sense of History On the Political Implications of Karl Lowith's Concept of Secularization | Barash Jeffrey Andrew 1998 Feb 01 | Published in Journal History and Theory Volume 37 Issue 1 Page 69. | ISSN:0018-2656,0,0,3,0,3,3,0,100,0,0,0,0,0
"getit.library.nyu.edu/resolve?url_ver=Z39.88-2004&rft_val_fmt=info:ofi/fmt:kev:mtx:journal&genre=article&sid=ProQ:ProQ:socabs&atitle=Through+the+Prism+of+Slavery:+Labor,+Capital,+and+World+Economy&title=American+Journal+of+Sociology&issn=00029602&date=2005-11-01&volume=111&issue=3&spage=933&au=Arrighi,+Giovanni;Tomich,+Dale+W&isbn=&jtitle=American+Journal+of+Sociology&btitle=&rft_id=info:eric/200611306&rft_id=info:doi/",Article | Through the Prism of Slavery Labor Capital and World Economy | Arrighi Giovanni 2005 Nov 01 | Published in Journal American Journal of Sociology Volume 111 Issue 3 Page 933. | ISSN:0002-9602,1,1,1,2,2,4,50,50,0,0,0,0,0
"getit.library.nyu.edu/resolve?url_ver=Z39.88-2004&rft_val_fmt=info:ofi/fmt:kev:mtx:journal&genre=article&sid=ProQ:ProQ:socabs&atitle=WOMEN'S+STRUGGLE+FOR+EQUALITY+OF+OPPORTUNITY&title=The+American+Journal+of+Economics+and+Sociology&issn=00029246&date=1961-10-01&volume=20&issue=5&spage=542&au=Mangum,+Milton&isbn=&jtitle=The+American+Journal+of+Economics+and+Sociology&btitle=&rft_id=info:eric/63A4292&rft_id=info:doi/",Article | WOMEN'S STRUGGLE FOR EQUALITY OF OPPORTUNITY | Mangum Milton 1961 Oct 01 | Published in Journal The American Journal of Economics and Sociology Volume 20 Issue 5 Page 542. | ISSN:0002-9246,1,2,1,3,2,5,60,40,0,0,0,0,0
"getit.library.nyu.edu/resolve?url_ver=Z39.88-2004&rft_val_fmt=info:ofi/fmt:kev:mtx:journal&genre=article&sid=ProQ:ProQ:socscijournals&atitle=Bachata:+A+social+history+of+a+Dominican+popular+music&title=Journal+of+the+Royal+Anthropological+Institute&issn=13590987&date=1997-03-01&volume=3&issue=1&spage=169&au=Reily,+Suzel+Ana&isbn=&jtitle=Journal+of+the+Royal+Anthropological+Institute&btitle=&rft_id=info:eric/&rft_id=info:doi/",Article | Bachata A social history of a Dominican popular music | Reily Suzel Ana 1997 Mar 01 | Published in Journal Journal of the Royal Anthropological Institute Volume 3 Issue 1 Page 169. | ISSN:1359-0987,2,2,1,4,3,7,57,43,0,0,0,0,0
"getit.library.nyu.edu/resolve?url_ver=Z39.88-2004&rft_val_fmt=info:ofi/fmt:kev:mtx:journal&genre=article&sid=ProQ:ProQ:wpsa&atitle=INTERNATIONAL+LAW:+THE+CRITICS+ARE+WRONG&title=FOREIGN+POLICY&issn=00157228&date=1988-01-01&volume=71&issue=&spage=22&au=Farer,+T+J&isbn=&jtitle=FOREIGN+POLICY&btitle=&rft_id=info:eric/8801344&rft_id=info:doi/",Article | INTERNATIONAL LAW THE CRITICS ARE WRONG | Farer T J 1988 Jan 01 | Published in Journal FOREIGN POLICY Volume 71 Page 22. | ISSN:0015-7228,1,1,1,2,2,4,50,50,0,0,0,0,0
"getit.library.nyu.edu/resolve?url_ver=Z39.88-2004&rft_val_fmt=info:ofi/fmt:kev:mtx:journal&genre=article&sid=ProQ:ProQ:wpsa&atitle=Views+of+an+Emigrant+From+the+'American+Dream'+to+the+'American+Experience'&title=Osteuropa&issn=00306428&date=2011-01-01&volume=61&issue=1&spage=93&au=Steiner,+Peter&isbn=&jtitle=Osteuropa&btitle=&rft_id=info:eric/201301463&rft_id=info:doi/",Article | Views of an Emigrant From the American Dream to the American Experience' | Steiner Peter 2011 Jan 01 | Published in Journal Osteuropa Volume 61 Issue 1 Page 93. | ISSN:0030-6428,0,1,1,1,1,2,50,50,0,0,0,0,0
"getit.library.nyu.edu/resolve?url_ver=Z39.88-2004&rft_val_fmt=info:ofi/fmt:kev:mtx:journal&genre=unknown&sid=ProQ:ProQ:iba&atitle=The+design+and+setting+of+Inigo+Jones's+Queen's+House,+1616-40&title=Court+historian&issn=14629712&date=2006-12-01&volume=11&issue=2&spage=135&au=Higgott,+Gordon&isbn=&jtitle=Court+historian&btitle=&rft_id=info:eric/20081231-00002751&rft_id=info:doi/",The design and setting of Inigo Jones's Queen's House 1616-40 | Higgott Gordon 2006 Dec 01 | Published in Court historian Volume 11 Issue 2 Page 135. | ISSN:1462-9712 | undefined,1,0,0,1,1,2,50,50,0,0,0,0,0
getit.library.nyu.edu/resolve?url_ver=Z39.88-2004&url_ctx_fmt=info:ofi/fmt:kev:mtx:ctx&ctx_tim=2011-11-10T13:05:53-05:00&ctx_ver=Z39.88-2004&ctx_enc=info:ofi/enc:UTF-8&ctx_id=&rfr_id=info:sid/sfxit.com:citation&rft.issn=0022-1058&rft_val_fmt=info:ofi/fmt:kev:mtx:journal,Journal | The Journal of extra-corporeal technology |  | ISSN:0022-1058 | undefined,1,0,0,1,1,2,50,50,0,0,0,0,0
getit.library.nyu.edu/resolve?url_ver=Z39.88-2004&url_ctx_fmt=info:ofi/fmt:kev:mtx:ctx&ctx_tim=2011-11-10T13:05:53-05:00&ctx_ver=Z39.88-2004&ctx_enc=info:ofi/enc:UTF-8&ctx_id=&rfr_id=info:sid/sfxit.com:citation&rft.issn=1540-7330&rft_val_fmt=info:ofi/fmt:kev:mtx:journal,Journal | Journal of prevention intervention in the community |  | ISSN:1085-2352 | undefined,1,0,0,1,1,2,50,50,0,0,0,0,0
getit.library.nyu.edu/resolve?url_ver=Z39.88-2004&url_ctx_fmt=info:ofi/fmt:kev:mtx:ctx&ctx_tim=2011-11-10T13:05:53-05:00&ctx_ver=Z39.88-2004&ctx_enc=info:ofi/enc:UTF-8&ctx_id=&rfr_id=info:sid/sfxit.com:citation&rft.issn=1677-6119&rft_val_fmt=info:ofi/fmt:kev:mtx:journal,Journal | INTERNATIONAL BRAZ J UROL |  | ISSN:1677-5538 | undefined,2,1,1,3,3,6,50,50,0,0,0,0,0
getit.library.nyu.edu/resolve?url_ver=Z39.88-2004&url_ctx_fmt=info:ofi/fmt:kev:mtx:ctx&ctx_tim=2011-11-10T13:05:53-05:00&ctx_ver=Z39.88-2004&ctx_enc=info:ofi/enc:UTF-8&ctx_id=&rfr_id=info:sid/sfxit.com:citation&rft.issn=2472-2448&rft_val_fmt=info:ofi/fmt:kev:mtx:journal,Journal | Psychopharmacology Bulletin |  | ISSN:0048-5764 | undefined,2,0,0,2,2,4,50,50,0,0,0,0,0
getit.library.nyu.edu/resolve?url_ver=Z39.88-2004&url_ctx_fmt=info:ofi/fmt:kev:mtx:ctx&ctx_ver=Z39.88-2004&ctx_tim=2021-06-27T11:05:37-04:00&ctx_id=&ctx_enc=info:ofi/enc:UTF-8&rft.genre=article&rft.isCitationLinker=Y&rft.doi=10.1086/712817&rft_val_fmt=info:ofi/fmt:kev:mtx:article&rft_id=info:doi/10.1086/712817&rfr_id=info:sid/primo.exlibrisgroup.com:primo4-article-cLinker,Article | The Dynamics of Retraction in Epistemic Networks | Lacroix Travis 2021 Jul | Published in Journal PHILOSOPHY OF SCIENCE Volume 88 Issue 3 Page 415 438. | ISSN:0031-8248,1,2,0,3,1,4,75,25,0,0,0,0,0
getit.library.nyu.edu/resolve?url_ver=Z39.88-2004&url_ctx_fmt=info:ofi/fmt:kev:mtx:ctx&ctx_ver=Z39.88-2004&ctx_tim=2021-06-27T13:16:46-04:00&ctx_id=&ctx_enc=info:ofi/enc:UTF-8&rft.genre=article&rft.isCitationLinker=Y&rft.atitle=Nitrogen+reduction+to+ammonia+at+high+efficiency&rft.jtitle=Science&rft.object_id=954925443632&rft.issn=0036-8075&rft_val_fmt=info:ofi/fmt:kev:mtx:article&rft_id=info:lccn/17024346&rfr_id=info:sid/primo.exlibrisgroup.com:primo4-article-cLinker,Article | Nitrogen reduction to ammonia at high efficiency | Published in Journal SCIENCE. | ISSN:0036-8075 | undefined,0,0,12,0,12,12,0,100,0,0,0,0,0
getit.library.nyu.edu/resolve?url_ver=Z39.88-2004&url_ctx_fmt=info:ofi/fmt:kev:mtx:ctx&ctx_ver=Z39.88-2004&ctx_tim=2021-07-14T23:37:04-04:00&ctx_id=&ctx_enc=info:ofi/enc:UTF-8&rft.genre=article&rft.isCitationLinker=Y&rft.pmid=34017087&rft_val_fmt=info:ofi/fmt:kev:mtx:article&rft_id=info:pmid/34017087&rfr_id=info:sid/primo.exlibrisgroup.com:primo4-article-cLinker,Article | TP53 mutations increase radioresistance in rhabdomyosarcoma and Ewing sarcoma. | Casey Dana L 2021 | Published in Journal BRITISH JOURNAL OF CANCER Volume 125 Issue 4 Page 576 581. | ISSN:0007-0920,3,3,2,6,5,11,55,45,0,0,0,0,0
getit.library.nyu.edu/resolve?url_ver=Z39.88-2004&url_ctx_fmt=info:ofi/fmt:kev:mtx:ctx&ctx_ver=Z39.88-2004&ctx_tim=2021-07-22T16:08:44-04:00&ctx_id=&ctx_enc=info:ofi/enc:UTF-8&rft.genre=article&rft.isCitationLinker=Y&rft.jtitle=Journal+of+Health+Care+for+the+Poor+and+Underserved&rft.object_id=954925592452&rft.issn=1049-2089&rft_val_fmt=info:ofi/fmt:kev:mtx:article&rft_id=info:lccn/2004212123&rfr_id=info:sid/primo.exlibrisgroup.com:primo4-article-cLinker,Article | JOURNAL OF HEALTH CARE FOR THE POOR AND UNDERSERVED |  | ISSN:1049-2089 | undefined,3,2,1,5,4,9,56,44,0,0,0,0,0
getit.library.nyu.edu/resolve?url_ver=Z39.88-2004&url_ctx_fmt=info:ofi/fmt:kev:mtx:ctx&ctx_ver=Z39.88-2004&ctx_tim=2021-08-19T08:40:21-04:00&ctx_id=&ctx_enc=info:ofi/enc:UTF-8&rft.genre=article&rft.isCitationLinker=Y&rft.jtitle=American+Journal+of+Physical+Anthropology&rft.object_id=954925377905&rft.issn=0002-9483&rft_val_fmt=info:ofi/fmt:kev:mtx:article&rft_id=info:lccn/sn97001323&rfr_id=info:sid/primo.exlibrisgroup.com:primo4-article-cLinker,Article | American Journal of Physical Anthropology |  | ISSN:0002-9483 | undefined,1,0,0,1,1,2,50,50,0,0,0,0,0
getit.library.nyu.edu/resolve?url_ver=Z39.88-2004&url_ctx_fmt=info:ofi/fmt:kev:mtx:ctx&ctx_ver=Z39.88-2004&ctx_tim=2021-08-22T15:48:09-04:00&ctx_id=&ctx_enc=info:ofi/enc:UTF-8&rft.genre=article&rft.isCitationLinker=Y&rft.doi=10.1111/j.1469-8749.2003.tb00951.x&rft_val_fmt=info:ofi/fmt:kev:mtx:article&rft_id=info:doi/10.1111/j.1469-8749.2003.tb00951.x&rfr_id=info:sid/primo.exlibrisgroup.com:primo4-article-cLinker,Article | Autism primary pragmatic difficulties and specific language impairment can we distinguish them using psycholinguistic markers? | Botting Nicola 2003 Aug | Published in Journal DEVELOPMENTAL MEDICINE AND CHILD NEUROLOGY Volume 45 Issue 8 Page 515 524. | ISSN:0012-1622,5,0,0,5,5,10,50,50,0,0,0,0,0
getit.library.nyu.edu/resolve?url_ver=Z39.88-2004&url_ctx_fmt=info:ofi/fmt:kev:mtx:ctx&ctx_ver=Z39.88-2004&ctx_tim=2021-09-23T09:17:59-04:00&ctx_id=&ctx_enc=info:ofi/enc:UTF-8&rft.genre=article&rft.isCitationLinker=Y&rft.atitle=Booking+the+Return+Trip:+Ovid+and+Tristia+1&rft.jtitle=Proceedings+of+the+Cambridge+Philological+Society&rft.object_id=954925459057&rft.issn=0068-6735&rft_val_fmt=info:ofi/fmt:kev:mtx:article&rft_id=info:lccn/06008206&rfr_id=info:sid/primo.exlibrisgroup.com:primo4-article-cLinker,Article | Booking the Return Trip Ovid and Tristia 1 | Published in Journal Proceedings of the Cambridge Philological Society. | ISSN:0068-6735 | undefined,1,0,1,1,2,3,33,67,0,0,0,0,0
getit.library.nyu.edu/resolve?url_ver=Z39.88-2004&url_ctx_fmt=info:ofi/fmt:kev:mtx:ctx&ctx_ver=Z39.88-2004&ctx_tim=2021-09-23T20:02:57-04:00&ctx_id=&ctx_enc=info:ofi/enc:UTF-8&rft.genre=article&rft.isCitationLinker=Y&rft.atitle=Plautus\u2019+Pseudolus:+The+Long+and+The+Short+of+It&rft.jtitle=Text+&+Presentation=&rft_val_fmt=info:ofi/fmt:kev:mtx:article&rfr_id=info:sid/primo.exlibrisgroup.com:primo4-article-cLinker,Article | Plautus\u2019 Pseudolus The Long and The Short of It | Published in Journal Text. | ISSN:0736-3974 | undefined,1,0,1,1,2,3,33,67,0,0,0,0,0
"getit.library.nyu.edu/resolve?url_ver=Z39.88-2004&url_ctx_fmt=info:ofi/fmt:kev:mtx:ctx&ctx_ver=Z39.88-2004&ctx_tim=2021-09-25T11:28:51IST&ctx_id=&ctx_enc=info:ofi/enc:UTF-8&rft.genre=book&rft.btitle=Behave+:+the+biology+of+humans+at+our+best+and+worst&rft.aulast=Sapolsky&rft.aufirst=Robert+M.,&rft.au=Sapolsky,+Robert+M.&rft.isbn=9780735222786&rft.primo=nyu_aleph007505197&rft_val_fmt=info:ofi/fmt:kev:mtx:book&rft_id=info:pmid/&rft_dat=<nyu_aleph>007505197</nyu_aleph><grp_id>794206546</grp_id><oa></oa><url></url>&req.language=eng&rfr_id=info:sid/primo.exlibrisgroup.com:primo-nyu_aleph007505197",Book | Behave the biology of humans at our best and worst | Sapolsky Robert M 2017 |  | Publisher:Penguin Books ISBN:9780735222786,0,0,1,0,1,1,0,100,0,0,0,0,0
getit.library.nyu.edu/resolve?url_ver=Z39.88-2004&url_ctx_fmt=info:ofi/fmt:kev:mtx:ctx&ctx_ver=Z39.88-2004&ctx_tim=2021-10-04T15:41:13-04:00&ctx_id=&ctx_enc=info:ofi/enc:UTF-8&rft.genre=article&rft.isCitationLinker=Y&rft.jtitle=Games+and+Culture&rft.object_id=1000000000033984&rft.issn=1555-4120&rft_val_fmt=info:ofi/fmt:kev:mtx:article&rft_id=info:lccn/2005212230&rfr_id=info:sid/primo.exlibrisgroup.com:primo4-article-cLinker,Article | GAMES AND CULTURE |  | ISSN:1555-4120 | undefined,1,0,0,1,1,2,50,50,0,0,0,0,0
getit.library.nyu.edu/resolve?url_ver=Z39.88-2004&url_ctx_fmt=info:ofi/fmt:kev:mtx:ctx&ctx_ver=Z39.88-2004&ctx_tim=2021-11-16T11:02:01-05:00&ctx_id=&ctx_enc=info:ofi/enc:UTF-8&rft.genre=article&rft.isCitationLinker=Y&rft.doi=10.1038/nrendo.2016.222&rft_val_fmt=info:ofi/fmt:kev:mtx:article&rft_id=info:doi/10.1038/nrendo.2016.222&rfr_id=info:sid/primo.exlibrisgroup.com:primo4-article-cLinker,Article | The cellular and molecular bases of leptin and ghrelin resistance in obesity | Cui Huxing 2017 | Published in Journal NATURE REVIEWS ENDOCRINOLOGY Volume 13 Issue 6 Page 338 351. | ISSN:1759-5029,5,0,0,5,5,10,50,50,0,0,0,0,0
getit.library.nyu.edu/resolve?url_ver=Z39.88-2004&url_ctx_fmt=info:ofi/fmt:kev:mtx:ctx&ctx_ver=Z39.88-2004&ctx_tim=2021-11-28T21:07:22-05:00&ctx_id=&ctx_enc=info:ofi/enc:UTF-8&rft.genre=article&rft.isCitationLinker=Y&rft.doi=10.1371/journal.pone.0164229&rft_val_fmt=info:ofi/fmt:kev:mtx:article&rft_id=info:doi/10.1371/journal.pone.0164229&rfr_id=info:sid/primo.exlibrisgroup.com:primo4-article-cLinker,"Article | Designing an iPad App to Monitor and Improve Classroom Behavior for Children with ADHD iSelfControl Feasibility and Pilot Studies | Schuck Sabrina 2016 Oct 14 | Published in Journal PLOS ONE Volume 11 Issue 10 Page e0164229. | ",10,0,0,10,10,20,50,50,0,0,0,0,0
getit.library.nyu.edu/resolve?url_ver=Z39.88-2004&url_ctx_fmt=info:ofi/fmt:kev:mtx:ctx&ctx_ver=Z39.88-2004&ctx_tim=2021-11-28T21:13:48-05:00&ctx_id=&ctx_enc=info:ofi/enc:UTF-8&rft.genre=article&rft.isCitationLinker=Y&rft.doi=10.1089/g4h.2015.0103&rft_val_fmt=info:ofi/fmt:kev:mtx:article&rft_id=info:doi/10.1089/g4h.2015.0103&rfr_id=info:sid/primo.exlibrisgroup.com:primo4-article-cLinker,Article | A Feasibility Study on the Effectiveness of a Full-Body Videogame Intervention for Decreasing Attention Deficit Hyperactivity Disorder Symptoms | Weerdmeester Joanneke 2016 | Published in Journal GAMES FOR HEALTH JOURNAL Volume 5 Issue 4 Page 258 269. | ISSN:2161-783X,1,0,0,1,1,2,50,50,0,0,0,0,0
getit.library.nyu.edu/resolve?url_ver=Z39.88-2004&url_ctx_fmt=info:ofi/fmt:kev:mtx:ctx&ctx_ver=Z39.88-2004&ctx_tim=2021-11-29T21:30:35-05:00&ctx_id=&ctx_enc=info:ofi/enc:UTF-8&rft.genre=article&rft.isCitationLinker=Y&rft.doi=10.3390/s21093221&rft_val_fmt=info:ofi/fmt:kev:mtx:article&rft_id=info:doi/10.3390/s21093221&rfr_id=info:sid/primo.exlibrisgroup.com:primo4-article-cLinker,Article | Detecting Attention Levels in ADHD Children with a Video Game and the Measurement of Brain Activity with a Single-Channel BCI Headset | Serrano Barroso Almudena 2021 | Published in Journal SENSORS Volume 21 Issue 9 Page 3221. | ISSN:1424-8220,3,1,1,4,4,8,50,50,0,0,0,0,0
getit.library.nyu.edu/resolve?url_ver=Z39.88-2004&url_ctx_fmt=info:ofi/fmt:kev:mtx:ctx&ctx_ver=Z39.88-2004&ctx_tim=2021-12-02T10:01:17-05:00&ctx_id=&ctx_enc=info:ofi/enc:UTF-8&rft.genre=article&rft.isCitationLinker=Y&rft.doi=10.1073/pnas.2101006118&rft_val_fmt=info:ofi/fmt:kev:mtx:article&rft_id=info:doi/10.1073/pnas.2101006118&rfr_id=info:sid/primo.exlibrisgroup.com:primo4-article-cLinker,Article | Observing the base-by-base search for native structure along transition paths during the folding of single nucleic acid hairpins | Hoffer Noel Q 2021 Dec 07 | Published in Journal PROCEEDINGS OF THE NATIONAL ACADEMY OF SCIENCES OF THE UNITED STATES OF AMERICA Volume 118 Issue 49. | ISSN:0027-8424,0,0,2,0,2,2,0,100,0,0,0,0,0
getit.library.nyu.edu/resolve?url_ver=Z39.88-2004&url_ctx_fmt=info:ofi/fmt:kev:mtx:ctx&ctx_ver=Z39.88-2004&ctx_tim=2021-12-05T11:19:25-05:00&ctx_id=&ctx_enc=info:ofi/enc:UTF-8&rft.genre=article&rft.isCitationLinker=Y&rft.date=2010&rft.atitle=Developing+anti-oppressive+services+for+the+poor:+A+theoretical+and+organizational+rationale&rft.jtitle=The+British+Journal+of+Social+Work&rft.aulast=Strier&rft.object_id=954925454946&rft.issn=0045-3102&rft_val_fmt=info:ofi/fmt:kev:mtx:article&rft_id=info:lccn/76617152&rfr_id=info:sid/primo.exlibrisgroup.com:primo4-article-cLinker,Article | Developing anti-oppressive services for the poor A theoretical and organizational rationale | Strier 2010 | Published in Journal BRITISH JOURNAL OF SOCIAL WORK. | ISSN:0045-3102,3,1,0,4,3,7,57,43,0,0,0,0,0
getit.library.nyu.edu/resolve?url_ver=Z39.88-2004&url_ctx_fmt=info:ofi/fmt:kev:mtx:ctx&ctx_ver=Z39.88-2004&ctx_tim=2021-12-05T23:00:23-05:00&ctx_id=&ctx_enc=info:ofi/enc:UTF-8&rft.genre=article&rft.isCitationLinker=Y&rft.doi=https://doi.org/10.1097/00012272-199706000-00004&rft_val_fmt=info:ofi/fmt:kev:mtx:article&rft_id=info:doi/https://doi.org/10.1097/00012272-199706000-00004&rfr_id=info:sid/primo.exlibrisgroup.com:primo4-article-cLinker,Article | Beyond True and False Memories Remembering and Recovery in the Survival of Childhood Sexual Abuse | Hall Joanne M 1997 | Published in Journal ADVANCES IN NURSING SCIENCE Volume 19 Issue 4 Page 37 54. | ISSN:0161-9268,2,1,0,3,2,5,60,40,0,0,0,0,0
getit.library.nyu.edu/resolve?url_ver=Z39.88-2004&url_ctx_fmt=info:ofi/fmt:kev:mtx:ctx&ctx_ver=Z39.88-2004&ctx_tim=2021-12-06T10:22:46-05:00&ctx_id=&ctx_enc=info:ofi/enc:UTF-8&rft.genre=article&rft.isCitationLinker=Y&rft.jtitle=Neurology&rft.object_id=954925246073&rft.issn=0028-3878&rft_val_fmt=info:ofi/fmt:kev:mtx:article&rft_id=info:lccn/55043902&rfr_id=info:sid/primo.exlibrisgroup.com:primo4-article-cLinker,Article | NEUROLOGY |  | ISSN:0028-3878 | undefined,3,0,0,3,3,6,50,50,0,0,0,0,0
getit.library.nyu.edu/resolve?url_ver=Z39.88-2004&url_ctx_fmt=info:ofi/fmt:kev:mtx:ctx&ctx_ver=Z39.88-2004&ctx_tim=2021-12-07T21:00:50-05:00&ctx_id=&ctx_enc=info:ofi/enc:UTF-8&rft.genre=article&rft.isCitationLinker=Y&rft.date=2021&rft.atitle=Endophenotype-based+in+silico+network+medicine+discovery+combined+with+insurance+record+data+mining+identifies+sildenafil+as+a+candidate+drug+for+Alzheimer\u2019s+disease&rft.jtitle=Nature+Aging&rft.object_id=5410000000084371&rft.issn=2662-8465&rft_val_fmt=info:ofi/fmt:kev:mtx:article&rfr_id=info:sid/primo.exlibrisgroup.com:primo4-article-cLinker,Article | Endophenotype-based in silico network medicine discovery combined with insurance record data mining identifies sildenafil as a candidate drug for Alzheimer\u2019s disease | 2021 | Published in Journal Nature Aging. | ISSN:2662-8465,2,0,0,2,2,4,50,50,0,0,0,0,0
getit.library.nyu.edu/resolve?url_ver=Z39.88-2004&url_ctx_fmt=info:ofi/fmt:kev:mtx:ctx&ctx_ver=Z39.88-2004&ctx_tim=2021-12-11T17:56:41-05:00&ctx_id=&ctx_enc=info:ofi/enc:UTF-8&rft.genre=article&rft.isCitationLinker=Y&rft.date=2013&rft.atitle=Breaking+the+links+in+intergenerational+violence:+An+emotional+regulation+perspective&rft.jtitle=Family+Process&rft.volume=52&rft.issue=2&rft.object_id=954925399507&rft.issn=0014-7370&rft_val_fmt=info:ofi/fmt:kev:mtx:article&rft_id=info:lccn/67003256&rfr_id=info:sid/primo.exlibrisgroup.com:primo4-article-cLinker,Article | Breaking the links in intergenerational violence An emotional regulation perspective | 2013 | Published in Journal FAMILY PROCESS Volume 52 Issue 2. | ISSN:0014-7370,2,0,0,2,2,4,50,50,0,0,0,0,0
getit.library.nyu.edu/resolve?url_ver=Z39.88-2004&url_ctx_fmt=info:ofi/fmt:kev:mtx:ctx&ctx_ver=Z39.88-2004&ctx_tim=2021-12-12T20:24:18-05:00&ctx_id=&ctx_enc=info:ofi/enc:UTF-8&rft.genre=article&rft.isCitationLinker=Y&rft.doi=10.1080/10428232.2015.1063361+&rft_val_fmt=info:ofi/fmt:kev:mtx:article&rft_id=info:doi/10.1080/10428232.2015.1063361&rfr_id=info:sid/primo.exlibrisgroup.com:primo4-article-cLinker,Article | White Privilege and Clinical Social Work Practice Reflections and Recommendations | Davis Ashley 2015 | Published in Journal Journal of Progressive Human Services Volume 26 Issue 3 Page 191 208. | ISSN:1042-8232,0,0,1,0,1,1,0,100,0,0,0,0,0
getit.library.nyu.edu/resolve?url_ver=Z39.88-2004&url_ctx_fmt=info:ofi/fmt:kev:mtx:ctx&ctx_ver=Z39.88-2004&ctx_tim=2021-12-14T13:47:33-05:00&ctx_id=&ctx_enc=info:ofi/enc:UTF-8&rft.genre=article&rft.isCitationLinker=Y&rft.doi=10.1177/1403494820982106&rft_val_fmt=info:ofi/fmt:kev:mtx:article&rft_id=info:doi/10.1177/1403494820982106&rfr_id=info:sid/primo.exlibrisgroup.com:primo4-article-cLinker,Article | Health-system equity egalitarian democracy and COVID-19 outcomes An empirical analysis | Vadlamannati Krishna Chaitanya 2021 Feb 09 | Published in Journal SCANDINAVIAN JOURNAL OF PUBLIC HEALTH Volume 49 Issue 1 Page 104 113. | ISSN:1403-4948,1,2,0,3,1,4,75,25,0,0,0,0,0
getit.library.nyu.edu/resolve?url_ver=Z39.88-2004&url_ctx_fmt=info:ofi/fmt:kev:mtx:ctx&ctx_ver=Z39.88-2004&ctx_tim=2021-12-15T13:32:56-05:00&ctx_id=&ctx_enc=info:ofi/enc:UTF-8&rft.genre=article&rft.isCitationLinker=Y&rft.doi=https://doi.org/10.2307/3096325&rft_val_fmt=info:ofi/fmt:kev:mtx:article&rft_id=info:doi/https://doi.org/10.2307/3096325&rfr_id=info:sid/primo.exlibrisgroup.com:primo4-article-cLinker,Article | Freedom Unfinished Fundamentalism and Popular Resistance in Bangladesh Today By Jeremy Seabrook London and New York Zed Books Dhaka Proshika 2001 xi 243 pp 25.00 14.95. | Menon Ritu 2003 | Published in Journal JOURNAL OF ASIAN STUDIES Volume 62 Issue 2 Page 685 686. | ISSN:0021-9118,6,5,0,11,6,17,65,35,0,0,0,0,0
"getit.library.nyu.edu/resolve?url_ver=Z39.88-2004&url_ctx_fmt=info:ofi/fmt:kev:mtx:ctx&ctx_ver=Z39.88-2004&ctx_tim=2021-12-17T13:43:03-05:00&ctx_id=&ctx_enc=info:ofi/enc:UTF-8&rft.genre=article&rft.isCitationLinker=Y&rft.date=2009&rft.atitle=The+Art+of+Wu+Guanzhong:+A+Decussation+of+Cultures&rft.jtitle=Passage&rft.aulast=Chow,+Kwok+Kian&rft.aufirst=Kwok+Kian&rft.object_id=110978978556293&rft.issn=0901-8883&rft_val_fmt=info:ofi/fmt:kev:mtx:article&rfr_id=info:sid/primo.exlibrisgroup.com:primo4-article-cLinker",Article | The Art of Wu Guanzhong A Decussation of Cultures | Chow Kwok Kian 2009 | Published in Journal Passage. | ISSN:0901-8883,2,0,0,2,2,4,50,50,0,0,0,0,0
getit.library.nyu.edu/resolve?url_ver=Z39.88-2004&url_ctx_fmt=info:ofi/fmt:kev:mtx:ctx&ctx_ver=Z39.88-2004&ctx_tim=2021-12-18T17:39:35-05:00&ctx_id=&ctx_enc=info:ofi/enc:UTF-8&rft.genre=article&rft.isCitationLinker=Y&rft.doi=https://doi.org/10.1017/S1744137410000081&rft_val_fmt=info:ofi/fmt:kev:mtx:article&rft_id=info:doi/https://doi.org/10.1017/S1744137410000081&rfr_id=info:sid/primo.exlibrisgroup.com:primo4-article-cLinker,Article | Civil liberties and economic development | Benyishay Ariel 2010 | Published in Journal JOURNAL OF INSTITUTIONAL ECONOMICS Volume 6 Issue 3 Page 281 304. | ISSN:1744-1374,2,0,0,2,2,4,50,50,0,0,0,0,0
getit.library.nyu.edu/resolve?url_ver=Z39.88-2004&url_ctx_fmt=info:ofi/fmt:kev:mtx:ctx&ctx_ver=Z39.88-2004&ctx_tim=2021-12-24T01:00:28-05:00&ctx_id=&ctx_enc=info:ofi/enc:UTF-8&rft.genre=article&rft.isCitationLinker=Y&rft.doi=10.1021/acs.jmedchem.1c00966&rft_val_fmt=info:ofi/fmt:kev:mtx:article&rft_id=info:doi/10.1021/acs.jmedchem.1c00966&rfr_id=info:sid/primo.exlibrisgroup.com:primo4-article-cLinker,Article | Installation of Pargyline a LSD1 Inhibitor in the HDAC Inhibitory Template Culminated in the Identification of a Tractable Antiprostate Cancer Agent | Ojha Ritu 2021 | Published in Journal JOURNAL OF MEDICINAL CHEMISTRY Volume 64 Issue 24 Page 17824 17845. | ISSN:0022-2623,0,0,1,0,1,1,0,100,0,0,0,0,0
getit.library.nyu.edu/resolve?url_ver=Z39.88-2004&url_ctx_fmt=info:ofi/fmt:kev:mtx:ctx&ctx_ver=Z39.88-2004&ctx_tim=2021-12-24T07:12:17-05:00&ctx_id=&ctx_enc=info:ofi/enc:UTF-8&rft.genre=article&rft.isCitationLinker=Y&rft.date=2013&rft.atitle=Martha+Marcy+May+Marlene&rft.jtitle=Attachment:+New+Directions+in+Psychotherapy+and+Relational+Psychoanalysis+Journal&rft.volume=7&rft.spage=219&rft.epage=221&rft.aulast=Epsteing&rft.auinit=OB&rft.object_id=1000000000294985&rft.issn=1753-5980&rft_val_fmt=info:ofi/fmt:kev:mtx:article&rfr_id=info:sid/primo.exlibrisgroup.com:primo4-article-cLinker,Article | Martha Marcy May Marlene | Epsteing O B 2013 | Published in Journal Attachment New Directions in Psychotherapy and Relational Psychoanalysis Journal Volume 7 Page 219 221. | ISSN:1753-5980,1,0,0,1,1,2,50,50,0,0,0,0,0
getit.library.nyu.edu/resolve?url_ver=Z39.88-2004&url_ctx_fmt=info:ofi/fmt:kev:mtx:ctx&ctx_ver=Z39.88-2004&ctx_tim=2021-12-27T05:33:12-05:00&ctx_id=&ctx_enc=info:ofi/enc:UTF-8&rft.genre=article&rft.isCitationLinker=Y&rft.issn=1381-4338&rft_val_fmt=info:ofi/fmt:kev:mtx:article&rfr_id=info:sid/primo.exlibrisgroup.com:primo4-article-cLinker,Article | JOURNAL OF ECONOMIC GROWTH |  | ISSN:1381-4338 | undefined,4,1,0,5,4,9,56,44,0,0,0,0,0
getit.library.nyu.edu/resolve?url_ver=Z39.88-2004&url_ctx_fmt=info:ofi/fmt:kev:mtx:ctx&ctx_ver=Z39.88-2004&ctx_tim=2022-01-05T02:04:50-05:00&ctx_id=&ctx_enc=info:ofi/enc:UTF-8&rft.genre=article&rft.isCitationLinker=Y&rft.jtitle=ACS+Medicinal+Chemistry+Letters&rft.object_id=1000000000792042&rft.issn=1948-5875&rft_val_fmt=info:ofi/fmt:kev:mtx:article&rfr_id=info:sid/primo.exlibrisgroup.com:primo4-article-cLinker,Article | ACS MEDICINAL CHEMISTRY LETTERS |  | ISSN:1948-5875 | undefined,0,0,2,0,2,2,0,100,0,0,0,0,0
getit.library.nyu.edu/resolve?url_ver=Z39.88-2004&url_ctx_fmt=info:ofi/fmt:kev:mtx:ctx&ctx_ver=Z39.88-2004&ctx_tim=2022-01-05T02:29:29-05:00&ctx_id=&ctx_enc=info:ofi/enc:UTF-8&rft.genre=article&rft.isCitationLinker=Y&rft.jtitle=Chemical+Communications+(Cambridge)&rft.object_id=954925278588&rft.issn=1359-7345&rft_val_fmt=info:ofi/fmt:kev:mtx:article&rft_id=info:lccn/96660034&rfr_id=info:sid/primo.exlibrisgroup.com:primo4-article-cLinker,Article | CHEMICAL COMMUNICATIONS |  | ISSN:1359-7345 | undefined,1,0,0,1,1,2,50,50,0,0,0,0,0
getit.library.nyu.edu/resolve?url_ver=Z39.88-2004&url_ctx_fmt=info:ofi/fmt:kev:mtx:ctx&ctx_ver=Z39.88-2004&ctx_tim=2022-01-07T15:16:31-05:00&ctx_id=&ctx_enc=info:ofi/enc:UTF-8&rft.genre=article&rft.isCitationLinker=Y&rft.date=1985&rft.atitle=The+Bodymind+Experience&rft.jtitle=Philosophy+East+and+West&rft.aulast=Shaner&rft.aufirst=David&rft.object_id=954925433397&rft.issn=0031-8221&rft_val_fmt=info:ofi/fmt:kev:mtx:article&rft_id=info:lccn/00214400&rfr_id=info:sid/primo.exlibrisgroup.com:primo4-article-cLinker,Article | The Bodymind Experience | Shaner David 1985 | Published in Journal Philosophy East and West. | ISSN:0031-8221,0,0,2,0,2,2,0,100,0,0,0,0,0
getit.library.nyu.edu/resolve?url_ver=Z39.88-2004&url_ctx_fmt=info:ofi/fmt:kev:mtx:ctx&ctx_ver=Z39.88-2004&ctx_tim=2022-01-13T11:32:11-05:00&ctx_id=&ctx_enc=info:ofi/enc:UTF-8&rft.genre=article&rft.isCitationLinker=Y&rft.jtitle=New+York+times&rft.object_id=5300000000000814&rft_val_fmt=info:ofi/fmt:kev:mtx:article&rfr_id=info:sid/primo.exlibrisgroup.com:primo4-article-cLinker,Article | New York times |  |  | undefined,1,0,0,1,1,2,50,50,0,0,0,0,0
getit.library.nyu.edu/resolve?url_ver=Z39.88-2004&url_ctx_fmt=info:ofi/fmt:kev:mtx:ctx&ctx_ver=Z39.88-2004&ctx_tim=2022-01-15T19:20:12-05:00&ctx_id=&ctx_enc=info:ofi/enc:UTF-8&rft.genre=article&rft.isCitationLinker=Y&rft.doi=https://doi.org/10.1353/lan.2003.0094&rft_val_fmt=info:ofi/fmt:kev:mtx:article&rft_id=info:doi/https://doi.org/10.1353/lan.2003.0094&rfr_id=info:sid/primo.exlibrisgroup.com:primo4-article-cLinker,Article | Policing the Content of Linguistic Examples | Postal Paul Martin 2003 | Published in Journal LANGUAGE Volume 79 Issue 1 Page 182 188. | ISSN:0097-8507,2,2,0,4,2,6,67,33,0,0,0,0,0
getit.library.nyu.edu/resolve?url_ver=Z39.88-2004&url_ctx_fmt=info:ofi/fmt:kev:mtx:ctx&ctx_ver=Z39.88-2004&ctx_tim=2022-01-25T11:42:51-05:00&ctx_id=&ctx_enc=info:ofi/enc:UTF-8&rft.genre=article&rft.isCitationLinker=Y&rft.atitle=Clinical+social+work's+contribution+to+a+social+justice+perspective.&rft.jtitle=Social+work&rft.aulast=swenson&rft.object_id=960238895522&rft.issn=0037-8054&rft_val_fmt=info:ofi/fmt:kev:mtx:article&rfr_id=info:sid/primo.exlibrisgroup.com:primo4-article-cLinker,"Article | Clinical social work's contribution to a social justice perspective. | swenson, | Published in Journal Social Work/Maatskaplike Werk. | ISSN:0037-8054",1,1,1,2,2,4,50,50,0,0,0,0,0
getit.library.nyu.edu/resolve?url_ver=Z39.88-2004&url_ctx_fmt=info:ofi/fmt:kev:mtx:ctx&ctx_ver=Z39.88-2004&ctx_tim=2022-01-30T18:51:28-05:00&ctx_id=&ctx_enc=info:ofi/enc:UTF-8&rft.genre=article&rft.isCitationLinker=Y&rft.atitle=impact+of+auditory+feedback+alterations+in+individuals+with+stuttering&rft.jtitle=Brazilian+journal+of+otorhinolaryngology&rft.aulast=fiorin&rft.object_id=1000000000815827&rft.issn=1808-8694&rft_val_fmt=info:ofi/fmt:kev:mtx:article&rft_id=info:lccn/2005243079&rfr_id=info:sid/primo.exlibrisgroup.com:primo4-article-cLinker,"Article | impact of auditory feedback alterations in individuals with stuttering | fiorin, | Published in Journal BRAZILIAN JOURNAL OF OTORHINOLARYNGOLOGY. | ISSN:1808-8694",3,1,1,4,4,8,50,50,0,0,0,0,0
getit.library.nyu.edu/resolve?url_ver=Z39.88-2004&url_ctx_fmt=info:ofi/fmt:kev:mtx:ctx&ctx_ver=Z39.88-2004&ctx_tim=2022-02-01T13:10:50-05:00&ctx_id=&ctx_enc=info:ofi/enc:UTF-8&rft.genre=article&rft.isCitationLinker=Y&rft.date=2002-10-25&rft.atitle=One-dimensional+Modelling+of+Thermoelectric+Cooling&rft.jtitle=Physica+status+solidi&rft.volume=194&rft.issue=1&rft.spage=277&rft.epage=290&rft.doi=10.1002/1521-396X(200211)194:1<277::AID-PSSA277>3.0.CO;2-5&rft.aulast=Seifert&rft.auinit=W&rft_val_fmt=info:ofi/fmt:kev:mtx:article&rft_id=info:doi/10.1002/1521-396X(200211)194:1<277::AID-PSSA277>3.0.CO;2-5&rfr_id=info:sid/primo.exlibrisgroup.com:primo4-article-cLinker,Article | One-dimensional Modelling of Thermoelectric Cooling | Seifert W 2002 Oct 25 | Published in Journal PHYSICA STATUS SOLIDI B-BASIC SOLID STATE PHYSICS Volume 194 Issue 1 Page 277 290. | ISSN:0370-1972,0,0,2,0,2,2,0,100,0,0,0,0,0
getit.library.nyu.edu/resolve?url_ver=Z39.88-2004&url_ctx_fmt=info:ofi/fmt:kev:mtx:ctx&ctx_ver=Z39.88-2004&ctx_tim=2022-03-24T22:20:37-04:00&ctx_id=&ctx_enc=info:ofi/enc:UTF-8&rft.genre=article&rft.isCitationLinker=Y&rft.doi=10.1172/JCI130808&rft_val_fmt=info:ofi/fmt:kev:mtx:article&rft_id=info:doi/10.1172/JCI130808&rfr_id=info:sid/primo.exlibrisgroup.com:primo4-article-cLinker,Article | GABA interneurons are the cellular trigger for ketamine’s rapid antidepressant actions | Gerhard Danielle M 2020 | Published in Journal JOURNAL OF CLINICAL INVESTIGATION Volume 130 Issue 3 Page 1336 1349. | ISSN:0021-9738,9,2,1,11,10,21,52,48,0,0,0,0,0
"getit.library.nyu.edu/resolve?url_ver=Z39.88-2004&url_ctx_fmt=info:ofi/fmt:kev:mtx:ctx&ctx_ver=Z39.88-2004&ctx_tim=2022-04-01T14:04:37IST&ctx_id=&ctx_enc=info:ofi/enc:UTF-8&rft.genre=book&rft.btitle=A+transpersonal+model+of+music+therapy+:+deepening+practice&rft.aulast=Crowe&rft.aufirst=Barbara+J.&rft.au=Crowe,+Barbara+J&rft.pub=Barcelona+Publishers&rft.place=Dallas,+TX&rft.isbn=9781945411274&rft.isbn_list=1945411279&rft.primo=nyu_aleph007652404&rft_val_fmt=info:ofi/fmt:kev:mtx:book&rft_id=info:pmid/&rft_dat=<nyu_aleph>007652404</nyu_aleph><grp_id>1150933587</grp_id><oa></oa><url></url>&req.language=eng&rfr_id=info:sid/primo.exlibrisgroup.com:primo-nyu_aleph007652404",Book | A transpersonal model of music therapy deepening practice | Crowe Barbara J 2017 |  | Publisher:Barcelona Publishers ISBN:9781945411274,0,0,4,0,4,4,0,100,0,0,0,0,0
"getit.library.nyu.edu/resolve?url_ver=Z39.88-2004&url_ctx_fmt=info:ofi/fmt:kev:mtx:ctx&rft.artnum=ARTN+1586&rft.atitle=Right-Censored+Time+Series+Modeling+by+Modified+Semi-Parametric+A-Spline+Estimator&rft.aufirst=Dursun&rft.auinit=D&rft.aulast=Aydin&rft.date=2021&rft_id=info:doi/10.3390/e23121586&rft.eissn=1099-4300&rft.genre=article&rft.issue=12&rft.jtitle=ENTROPY&rft_val_fmt=info:ofi/fmt:kev:mtx:journal&rfr_id=info:sid/webofscience.com:WOS:WOS&rft.stitle=ENTROPY-SWITZ&rft.volume=23&rft.au=Aydin,+D&rft.au=Ahmed,+SE&rft.au=Yilmaz,+E",Article | Right-Censored Time Series Modeling by Modified Semi-Parametric A-Spline Estimator | Aydin D 2021 | Published in Journal ENTROPY Volume 23 Issue 12 Page 1586. | ISSN:1099-4300,2,2,2,4,4,8,50,50,0,0,0,0,0
"getit.library.nyu.edu/resolve?url_ver=Z39.88-2004&url_ctx_fmt=info:ofi/fmt:kev:mtx:ctx&rft.artnum=ARTN+37&rft.atitle=Association+between+the+dispositional+optimism+and+depression+in+young+people:+a+systematic+review+and+meta-analysis&rft.aufirst=Fabio+Alexis&rft.auinit=FAR&rft.aulast=Rincon+Uribe&rft.date=2021&rft_id=info:doi/10.1186/s41155-021-00202-y&rft.eissn=1678-7153&rft.genre=article&rft.issn=0102-7972&rft.issue=1&rft.jtitle=PSICOLOGIA-REFLEXAO+E+CRITICA&rft_val_fmt=info:ofi/fmt:kev:mtx:journal&rfr_id=info:sid/webofscience.com:WOS:WOS&rft.stitle=PSICOL-REFLEX+CRIT&rft.volume=34&rft.au=Rincon+Uribe,+Fabio+Alexis&rft.au=de+Oliveira,+Silvia+Botelho&rft.au=Gouveia+Junior,+Amauri&rft.au=Pedroso,+Janari+da+Silva",Article | Association between the dispositional optimism and depression in young people a systematic review and meta-analysis | Rincon Uribe Fabio Alexis 2021 | Published in Journal PSICOLOGIA-REFLEXAO E CRITICA Volume 34 Issue 1. | ISSN:0102-7972,6,1,1,7,7,14,50,50,0,0,0,0,0
getit.library.nyu.edu/resolve?url_ver=Z39.88-2004&url_ctx_fmt=info:ofi/fmt:kev:mtx:ctx&rft.atitle=Paradoxes+of+Civic+Exclusion:+Explaining+Restrictions+on+Headscarves&rft.aufirst=Elaine+R.&rft.auinit=ER&rft.aulast=Thomas&rft.btitle=Paradoxes+of+Civic+Exclusion:+Explaining+Restrictions+on+Headscarves&rft.date=2012&rft.epage=199&rft.genre=bookitem&rft.isbn=978-0-8122-4332-1&rft_val_fmt=info:ofi/fmt:kev:mtx:book&rft.pages=182-199&rft.place=PHILADELPHIA&rft.pub=UNIV+PENNSYLVANIA+PRESS&rft.series=Pennsylvania+Studies+in+Human+Rights&rfr_id=info:sid/webofscience.com:WOS:WOS&rft.spage=182&rft.tpages=18,Book Chapter | Paradoxes of Civic Exclusion Explaining Restrictions on Headscarves | Thomas Elaine R 2012 | Published in Book Immigration Islam and the Politics of Belonging in France A Comparative Framework Page 182 199. | Publisher:UNIV PENNSYLVANIA PRESS ISBN:9780812243321,0,0,0,0,0,0,n/a,n/a,0,0,0,0,0
"getit.library.nyu.edu/resolve?url_ver=Z39.88-2004&url_ctx_fmt=info:ofi/fmt:kev:mtx:ctx&rft.atitle=Recent+Developments+on+the+Elucidation+of+Colloidal+Aspects+of+Asphaltenes+and+Their+Relevance+to+Oilfield+Problems&rft.aufirst=Lia+B.+S.&rft.auinit=LBS&rft.aulast=Balestrin&rft.date=2020&rft_id=info:doi/10.21577/0103-5053.20190257&rft.eissn=1678-4790&rft.epage=243&rft.genre=article&rft.issn=0103-5053&rft.issue=2&rft.jtitle=JOURNAL+OF+THE+BRAZILIAN+CHEMICAL+SOCIETY&rft_val_fmt=info:ofi/fmt:kev:mtx:journal&rft.pages=230-243&rfr_id=info:sid/webofscience.com:WOS:WOS&rft.spage=230&rft.stitle=J+BRAZIL+CHEM+SOC&rft.volume=31&rft.au=Balestrin,+Lia+B.+S.&rft.au=Loh,+Watson",Article | Recent Developments on the Elucidation of Colloidal Aspects of Asphaltenes and Their Relevance to Oilfield Problems | Balestrin Lia B S 2020 | Published in Journal JOURNAL OF THE BRAZILIAN CHEMICAL SOCIETY Volume 31 Issue 2 Page 230 243. | ISSN:0103-5053,0,1,1,1,1,2,50,50,0,0,0,0,0